日期,,縣市,附設校數總計,附設校數身心障礙類,附設校數資賦優異類,老師數總計,老師數身心障礙類,老師數資賦優異類,班級數總計,班級數身心障礙類小計,班級數身心障礙類集中式特教班,班級數身心障礙類分散式資源班,班級數身心障礙類巡迴輔導,班級數資賦優異類小計,班級數資賦優異類資優班(集中式),班級數資賦優異類美術班,班級數資賦優異類音樂班,班級數資賦優異類舞蹈班,班級數資賦優異類數理資源班,班級數資賦優異類資優巡迴輔導,學生人數總計,學生人數身心障礙類小計,學生人數身心障礙類集中式特教班,學生人數身心障礙類分散式資源班,學生人數身心障礙類巡迴輔導,學生人數身心障礙類接受特教服務,學生人數資賦優異類小計,學生人數資賦優異類資優班(集中式),學生人數資賦優異類美術班,學生人數資賦優異類音樂班,學生人數資賦優異類舞蹈班,學生人數資賦優異類數理資源班,學生人數資賦優異類資優巡迴輔導,學生人數資賦優異類資優方案
20090601,,台北市,59,38,21,336,123,213,167,63,29,34,0,104,74,0,12,9,6,3,4524,1720,392,475,15,838,2804,2018,0,339,245,122,79,1
20090601,,高雄市,17,11,6,94,46,48,40,20,12,8,0,20,3,2,6,6,3,0,1465,934,178,163,0,593,531,92,84,127,174,54,0,0
20090601,,台北縣,14,8,6,120,92,28,61,37,34,3,0,24,6,0,6,12,0,0,1883,1251,490,66,0,695,632,163,0,139,330,0,0,0
20090601,,宜蘭縣,10,7,3,80,24,56,31,16,9,7,0,15,6,0,3,3,3,0,780,424,102,265,0,57,356,178,0,85,44,49,0,0
20090601,,桃園縣,17,8,9,70,42,28,55,21,17,4,0,34,7,0,12,12,3,0,1897,976,248,117,1,610,921,227,0,335,302,57,0,0
20090601,,新竹縣,3,2,1,18,17,1,8,5,4,1,0,3,0,0,0,0,3,0,346,301,57,17,0,227,45,0,0,0,0,45,0,0
20090601,,苗栗縣,5,3,2,27,24,3,16,10,9,1,0,6,0,0,6,0,0,0,580,451,110,23,0,318,129,0,0,129,0,0,0,0
20090601,,台中縣,9,7,2,54,51,3,40,33,27,6,0,7,1,0,3,3,0,0,1528,1334,355,205,0,774,194,30,0,78,86,0,0,0
20090601,,彰化縣,14,11,3,85,46,39,44,26,15,11,0,18,12,0,3,3,0,0,1479,977,205,335,0,437,502,342,0,70,90,0,0,0
20090601,,南投縣,8,5,3,44,33,11,23,15,13,2,0,8,2,0,3,3,0,0,615,395,166,49,0,180,220,66,0,78,76,0,0,0
20090601,,雲林縣,6,3,3,66,15,51,26,15,15,0,0,11,5,0,3,3,0,0,703,430,171,0,1,258,273,145,0,59,69,0,0,0
20090601,,嘉義縣,2,2,0,8,8,0,6,6,6,0,0,0,0,0,0,0,0,0,318,318,69,0,0,249,0,0,0,0,0,0,0,0
20090601,,台南縣,9,7,2,65,44,21,30,24,19,5,0,6,0,0,6,0,0,0,906,815,262,222,1,330,91,0,0,91,0,0,0,0
20090601,,高雄縣,7,4,3,32,23,9,27,15,13,2,0,12,3,0,3,6,0,0,1202,882,170,49,0,663,320,88,0,81,151,0,0,0
20090601,,屏東縣,8,6,2,80,40,40,35,22,18,4,0,13,7,0,3,3,0,0,904,539,198,85,0,256,365,193,0,89,83,0,0,0
20090601,,台東縣,4,3,1,17,13,4,9,6,5,1,0,3,0,0,3,0,0,0,281,231,64,29,0,138,50,0,0,50,0,0,0,0
20090601,,花蓮縣,5,3,2,41,13,28,26,11,9,2,0,15,9,0,3,3,0,0,655,315,98,55,0,162,340,254,0,44,42,0,0,0
20090601,,澎湖縣,2,1,1,17,11,6,12,6,5,1,0,6,0,0,3,3,0,0,109,64,33,25,0,6,45,0,0,27,18,0,0,0
20090601,,基隆市,3,2,1,22,18,4,12,6,6,0,0,6,0,0,3,3,0,0,375,233,91,0,0,142,142,0,0,77,65,0,0,0
20090601,,新竹市,7,4,3,46,29,17,35,14,11,2,1,21,15,0,3,3,0,0,1101,504,149,49,0,306,597,430,0,78,89,0,0,0
20090601,,台中市,16,7,9,122,31,91,63,19,12,7,0,44,26,0,3,12,3,0,1906,726,177,321,0,228,1180,719,0,92,306,63,0,0
20090601,,嘉義市,4,2,2,50,7,43,25,4,3,1,0,21,12,0,3,3,3,0,786,219,37,21,0,161,567,332,0,87,100,48,0,0
20090601,,台南市,9,5,4,50,11,39,29,8,3,5,0,21,12,0,3,3,3,0,1125,581,45,135,0,401,544,317,0,90,89,48,0,0
20090601,,金門縣,1,1,0,19,19,0,4,4,3,1,0,0,0,0,0,0,0,0,54,54,25,25,0,4,0,0,0,0,0,0,0,0
20090601,,連江縣,0,0,0,0,0,0,0,0,0,0,0,0,0,0,0,0,0,0,7,7,0,0,0,7,0,0,0,0,0,0,0,0
20091020,,台北市,54,37,17,336,123,213,162,63,28,35,0,99,69,0,12,9,6,3,4533,1854,380,564,5,905,2679,1891,0,353,238,118,79,0
20091020,,高雄市,19,12,7,94,46,48,41,21,13,8,0,20,3,2,6,6,3,0,1651,1044,208,177,0,659,607,82,152,138,173,62,0,0
20091020,,台北縣,17,10,7,120,92,28,69,42,37,3,2,27,6,0,9,12,0,0,2083,1343,521,48,0,774,740,158,0,232,350,0,0,0
20091020,,宜蘭縣,10,7,3,80,24,56,31,16,9,7,0,15,6,0,3,3,3,0,852,495,114,214,0,167,357,178,0,87,45,47,0,0
20091020,,桃園縣,16,8,8,70,42,28,59,26,22,4,0,33,6,0,12,12,3,0,1812,1021,313,80,1,627,791,107,0,339,296,49,0,0
20091020,,新竹縣,5,4,1,18,17,1,11,8,7,1,0,3,0,0,0,0,3,0,385,337,87,12,0,238,48,0,0,0,0,48,0,0
20091020,,苗栗縣,6,4,2,27,24,3,18,12,10,2,0,6,0,0,6,0,0,0,624,481,125,31,0,325,143,0,0,143,0,0,0,0
20091020,,台中縣,10,8,2,54,51,3,40,34,27,7,0,6,0,0,3,3,0,0,1593,1427,363,214,1,849,166,0,0,79,87,0,0,0
20091020,,彰化縣,14,11,3,85,46,39,46,28,17,11,0,18,12,0,3,3,0,0,1487,1021,227,245,0,549,466,307,0,71,88,0,0,0
20091020,,南投縣,8,5,3,44,33,11,26,18,15,3,0,8,2,0,3,3,0,0,654,432,189,73,0,170,222,61,0,79,82,0,0,0
20091020,,雲林縣,6,3,3,66,15,51,27,15,15,0,0,12,6,0,3,3,0,0,758,487,181,0,0,306,271,148,0,67,56,0,0,0
20091020,,嘉義縣,2,2,0,8,8,0,6,6,6,0,0,0,0,0,0,0,0,0,301,301,68,0,0,233,0,0,0,0,0,0,0,0
20091020,,台南縣,10,8,2,65,44,21,31,25,19,6,0,6,0,0,6,0,0,0,974,891,274,180,1,436,83,0,0,83,0,0,0,0
20091020,,高雄縣,8,5,3,32,23,9,29,17,14,3,0,12,3,0,3,6,0,0,1128,874,175,68,0,631,254,57,0,77,120,0,0,0
20091020,,屏東縣,9,7,2,80,40,40,38,24,19,5,0,14,8,0,3,3,0,0,954,554,218,88,0,248,400,227,0,88,85,0,0,0
20091020,,台東縣,4,3,1,17,13,4,10,7,6,1,0,3,0,0,3,0,0,0,317,267,82,15,0,170,50,0,0,50,0,0,0,0
20091020,,花蓮縣,5,3,2,41,13,28,26,11,9,2,0,15,9,0,3,3,0,0,665,317,99,38,5,175,348,258,0,41,49,0,0,0
20091020,,澎湖縣,2,1,1,17,11,6,13,7,6,1,0,6,0,0,3,3,0,0,121,73,41,14,0,18,48,0,0,28,20,0,0,0
20091020,,基隆市,3,2,1,22,18,4,14,8,6,2,0,6,0,0,3,3,0,0,411,255,86,21,0,148,156,0,0,78,78,0,0,0
20091020,,新竹市,8,5,3,46,29,17,37,16,12,3,1,21,15,0,3,3,0,0,1185,596,168,52,0,376,589,432,0,78,79,0,0,0
20091020,,台中市,13,7,6,122,31,91,61,19,12,7,0,42,24,0,3,12,3,0,1925,810,171,287,0,352,1115,669,0,90,299,57,0,0
20091020,,嘉義市,4,2,2,50,7,43,25,4,3,1,0,21,12,0,3,3,3,0,813,240,39,13,0,188,573,337,0,89,100,47,0,0
20091020,,台南市,9,5,4,50,11,39,29,8,3,5,0,21,12,0,3,3,3,0,1194,649,45,109,0,495,545,316,0,90,88,51,0,0
20091020,,金門縣,1,1,0,19,19,0,4,4,3,1,0,0,0,0,0,0,0,0,63,63,29,22,0,12,0,0,0,0,0,0,0,0
20091020,,連江縣,0,0,0,0,0,0,0,0,0,0,0,0,0,0,0,0,0,0,6,6,0,0,0,6,0,0,0,0,0,0,0,0
20100322,,台北市,54,37,17,336,123,213,162,63,28,35,0,99,69,0,12,9,6,3,4456,1807,381,555,4,867,2649,1865,0,351,237,116,78,2
20100322,,高雄市,19,12,7,88,46,42,41,21,13,8,0,20,3,2,6,6,3,0,1669,1066,193,178,0,695,603,82,149,138,173,61,0,0
20100322,,台北縣,19,12,7,114,91,23,73,46,37,7,2,27,6,0,9,12,0,0,2078,1338,515,116,0,707,740,158,0,232,350,0,0,0
20100322,,宜蘭縣,10,7,3,81,25,56,31,16,9,7,0,15,6,0,3,3,3,0,849,496,115,214,0,167,353,177,0,84,45,47,0,0
20100322,,桃園縣,22,14,8,71,43,28,67,34,22,12,0,33,6,0,12,12,3,0,1849,1059,311,146,0,602,790,107,0,339,295,49,0,0
20100322,,新竹縣,6,5,1,13,12,1,14,11,7,4,0,3,0,0,0,0,3,0,379,331,89,77,0,165,48,0,0,0,0,48,0,0
20100322,,苗栗縣,7,5,2,24,24,0,21,15,10,5,0,6,0,0,6,0,0,0,616,474,120,123,0,231,142,0,0,142,0,0,0,0
20100322,,台中縣,17,15,2,54,51,3,48,42,27,15,0,6,0,0,3,3,0,0,1600,1434,353,358,0,723,166,0,0,79,87,0,0,0
20100322,,彰化縣,16,13,3,85,46,39,48,30,17,13,0,18,12,0,3,3,0,0,1468,1002,226,532,0,244,466,307,0,71,88,0,0,0
20100322,,南投縣,8,5,3,43,32,11,26,18,15,3,0,8,2,0,3,3,0,0,648,428,183,81,0,164,220,60,0,79,81,0,0,0
20100322,,雲林縣,8,5,3,67,16,51,32,20,15,5,0,12,6,0,3,3,0,0,786,487,177,1,0,309,299,176,0,66,57,0,0,0
20100322,,嘉義縣,2,2,0,9,9,0,6,6,6,0,0,0,0,0,0,0,0,0,294,294,67,0,0,227,0,0,0,0,0,0,0,0
20100322,,台南縣,13,11,2,66,45,21,36,30,20,10,0,6,0,0,6,0,0,0,974,891,276,219,1,395,83,0,0,83,0,0,0,0
20100322,,高雄縣,9,6,3,33,24,9,31,19,14,5,0,12,3,0,3,6,0,0,1128,875,192,390,0,293,253,57,0,77,119,0,0,0
20100322,,屏東縣,9,7,2,80,40,40,40,26,19,7,0,14,8,0,3,3,0,0,946,551,222,117,0,212,395,222,0,88,85,0,0,0
20100322,,台東縣,5,4,1,17,13,4,11,8,6,2,0,3,0,0,3,0,0,0,311,262,81,21,0,160,49,0,0,49,0,0,0,0
20100322,,花蓮縣,6,4,2,41,13,28,28,13,9,4,0,15,9,0,3,3,0,0,657,309,98,38,3,170,348,258,0,41,49,0,0,0
20100322,,澎湖縣,2,1,1,17,11,6,13,7,6,1,0,6,0,0,3,3,0,0,118,70,40,13,0,17,48,0,0,28,20,0,0,0
20100322,,基隆市,4,3,1,22,18,4,15,9,6,3,0,6,0,0,3,3,0,0,404,248,86,31,0,131,156,0,0,78,78,0,0,0
20100322,,新竹市,8,5,3,45,28,17,38,17,12,4,1,21,15,0,3,3,0,0,1178,589,166,76,0,347,589,432,0,78,79,0,0,0
20100322,,台中市,13,7,6,121,30,91,61,19,12,7,0,42,24,0,3,12,3,0,1930,814,173,284,0,357,1116,671,0,90,299,56,0,0
20100322,,嘉義市,5,3,2,50,7,43,26,5,3,2,0,21,12,0,3,3,3,0,803,232,37,48,0,147,571,337,0,89,98,47,0,0
20100322,,台南市,12,8,4,50,11,39,32,11,3,8,0,21,12,0,3,3,3,0,1194,649,45,158,0,446,545,316,0,90,88,51,0,0
20100322,,金門縣,1,1,0,20,20,0,4,4,3,1,0,0,0,0,0,0,0,0,59,59,27,21,0,11,0,0,0,0,0,0,0,0
20100322,,連江縣,0,0,0,0,0,0,0,0,0,0,0,0,0,0,0,0,0,0,6,6,0,0,0,6,0,0,0,0,0,0,0,0
20100528,,台北市,54,37,17,334,122,212,162,63,28,35,0,99,69,0,12,9,6,3,4454,1807,380,564,4,859,2647,1864,0,351,237,115,78,2
20100528,,高雄市,19,12,7,86,46,40,41,21,13,8,0,20,3,2,6,6,3,0,1660,1059,193,178,0,688,601,82,149,139,170,61,0,0
20100528,,台北縣,19,12,7,114,91,23,73,46,37,7,2,27,6,0,9,12,0,0,2069,1329,529,115,0,685,740,158,0,232,350,0,0,0
20100528,,宜蘭縣,10,7,3,76,24,52,31,16,9,7,0,15,6,0,3,3,3,0,839,486,130,212,0,144,353,177,0,84,45,47,0,0
20100528,,桃園縣,22,14,8,71,43,28,67,34,22,12,0,33,6,0,12,12,3,0,1841,1051,330,141,0,580,790,107,0,339,295,49,0,0
20100528,,新竹縣,6,5,1,13,12,1,14,11,7,4,0,3,0,0,0,0,3,0,380,332,94,77,0,161,48,0,0,0,0,48,0,0
20100528,,苗栗縣,7,5,2,24,24,0,21,15,10,5,0,6,0,0,6,0,0,0,613,472,137,120,0,215,141,0,0,141,0,0,0,0
20100528,,台中縣,17,15,2,54,51,3,48,42,27,15,0,6,0,0,3,3,0,0,1594,1428,398,356,0,674,166,0,0,79,87,0,0,0
20100528,,彰化縣,16,13,3,84,45,39,48,30,17,13,0,18,12,0,3,3,0,0,1458,993,263,521,0,209,465,307,0,71,87,0,0,0
20100528,,南投縣,8,5,3,43,32,11,26,18,15,3,0,8,2,0,3,3,0,0,647,429,188,81,0,160,218,60,0,79,79,0,0,0
20100528,,雲林縣,8,5,3,66,16,50,32,20,15,5,0,12,6,0,3,3,0,0,780,481,187,1,0,293,299,176,0,66,57,0,0,0
20100528,,嘉義縣,2,2,0,9,9,0,6,6,6,0,0,0,0,0,0,0,0,0,292,292,72,0,0,220,0,0,0,0,0,0,0,0
20100528,,台南縣,13,11,2,66,45,21,36,30,20,10,0,6,0,0,6,0,0,0,972,889,304,219,1,365,83,0,0,83,0,0,0,0
20100528,,高雄縣,9,6,3,33,24,9,31,19,14,5,0,12,3,0,3,6,0,0,1098,845,196,381,0,268,253,57,0,77,119,0,0,0
20100528,,屏東縣,9,7,2,79,40,39,40,26,19,7,0,14,8,0,3,3,0,0,949,547,224,117,0,206,402,229,0,88,85,0,0,0
20100528,,台東縣,5,4,1,17,13,4,11,8,6,2,0,3,0,0,3,0,0,0,311,262,85,21,0,156,49,0,0,49,0,0,0,0
20100528,,花蓮縣,6,4,2,40,13,27,28,13,9,4,0,15,9,0,3,3,0,0,645,297,97,38,3,159,348,258,0,41,49,0,0,0
20100528,,澎湖縣,2,1,1,17,11,6,13,7,6,1,0,6,0,0,3,3,0,0,108,60,30,13,0,17,48,0,0,28,20,0,0,0
20100528,,基隆市,4,3,1,22,18,4,15,9,6,3,0,6,0,0,3,3,0,0,405,249,93,31,0,125,156,0,0,78,78,0,0,0
20100528,,新竹市,8,5,3,45,28,17,38,17,12,4,1,21,15,0,3,3,0,0,1169,580,181,73,0,326,589,432,0,78,79,0,0,0
20100528,,台中市,13,7,6,121,30,91,61,19,12,7,0,42,24,0,3,12,3,0,1926,810,212,283,0,315,1116,671,0,90,299,56,0,0
20100528,,嘉義市,5,3,2,50,7,43,26,5,3,2,0,21,12,0,3,3,3,0,801,230,44,48,0,138,571,337,0,89,98,47,0,0
20100528,,台南市,12,8,4,50,11,39,32,11,3,8,0,21,12,0,3,3,3,0,1191,646,60,157,0,429,545,316,0,90,88,51,0,0
20100528,,金門縣,1,1,0,20,20,0,4,4,3,1,0,0,0,0,0,0,0,0,60,60,27,21,0,12,0,0,0,0,0,0,0,0
20100528,,連江縣,0,0,0,0,0,0,0,0,0,0,0,0,0,0,0,0,0,0,6,6,0,0,0,6,0,0,0,0,0,0,0,0
20101020,,台北市,54,36,18,372,120,252,159,62,27,35,0,97,70,0,12,9,6,0,4744,2087,378,678,0,1031,2657,1963,0,350,231,111,0,2
20101020,,高雄市,19,12,7,85,50,35,43,22,14,8,0,21,3,3,6,6,3,0,1860,1212,205,139,0,868,648,87,179,142,176,64,0,0
20101020,,台北縣,22,15,7,120,98,22,79,52,40,7,5,27,6,0,9,12,0,0,2286,1551,589,93,1,868,735,158,0,232,345,0,0,0
20101020,,宜蘭縣,10,7,3,103,29,74,31,16,9,7,0,15,6,0,3,3,3,0,884,552,116,136,0,300,332,174,0,69,42,47,0,0
20101020,,桃園縣,22,14,8,82,49,33,72,39,27,12,0,33,6,0,12,12,3,0,2058,1205,376,95,0,734,853,113,0,348,342,50,0,0
20101020,,新竹縣,6,5,1,14,13,1,17,14,10,4,0,3,0,0,0,0,3,0,425,370,126,48,0,196,55,0,0,0,0,55,0,0
20101020,,苗栗縣,7,5,2,24,24,0,22,16,11,5,0,6,0,0,6,0,0,0,672,522,138,98,0,286,150,0,0,150,0,0,0,0
20101020,,台中縣,17,15,2,60,54,6,49,43,28,15,0,6,0,0,3,3,0,0,1627,1450,377,247,0,826,177,0,0,89,88,0,0,0
20101020,,彰化縣,16,13,3,89,47,42,51,33,20,13,0,18,12,0,3,3,0,0,1538,1046,267,367,0,412,492,326,0,78,88,0,0,0
20101020,,南投縣,8,5,3,46,35,11,29,20,17,3,0,9,3,0,3,3,0,0,764,486,210,82,0,194,278,119,0,80,79,0,0,0
20101020,,雲林縣,8,5,3,67,17,50,32,20,15,5,0,12,6,0,3,3,0,0,819,545,191,0,0,354,274,143,0,78,53,0,0,0
20101020,,嘉義縣,2,2,0,8,8,0,6,6,6,0,0,0,0,0,0,0,0,0,323,323,67,0,0,256,0,0,0,0,0,0,0,0
20101020,,台南縣,13,11,2,64,48,16,37,31,21,10,0,6,0,0,6,0,0,0,1026,934,280,132,0,522,92,0,0,92,0,0,0,0
20101020,,高雄縣,9,6,3,46,32,14,32,20,15,5,0,12,3,0,3,6,0,0,1084,876,211,316,0,349,208,30,0,80,98,0,0,0
20101020,,屏東縣,9,7,2,80,40,40,41,26,20,6,0,15,9,0,3,3,0,0,983,563,257,76,0,230,420,263,0,78,79,0,0,0
20101020,,台東縣,5,4,1,17,13,4,12,9,7,2,0,3,0,0,3,0,0,0,330,280,81,12,0,187,50,0,0,50,0,0,0,0
20101020,,花蓮縣,6,4,2,40,13,27,28,13,9,4,0,15,9,0,3,3,0,0,612,343,110,26,3,204,269,171,0,52,46,0,0,0
20101020,,澎湖縣,2,1,1,17,11,6,11,5,4,1,0,6,0,0,3,3,0,0,108,66,32,10,0,24,42,0,0,25,17,0,0,0
20101020,,基隆市,4,3,1,19,16,3,15,9,6,3,0,6,0,0,3,3,0,0,401,247,83,31,0,133,154,0,0,80,74,0,0,0
20101020,,新竹市,8,5,3,46,34,12,40,19,14,4,1,21,15,0,3,3,0,0,1120,633,190,47,1,395,487,316,0,91,80,0,0,0
20101020,,台中市,14,8,6,127,35,92,62,20,12,7,1,42,24,0,3,12,3,0,1943,831,175,196,0,460,1112,685,0,88,281,58,0,0
20101020,,嘉義市,5,3,2,50,7,43,26,5,3,2,0,21,12,0,3,3,3,0,800,257,40,34,0,183,543,287,0,93,111,52,0,0
20101020,,台南市,12,8,4,51,13,38,32,11,3,8,0,21,12,0,3,3,3,0,1250,693,43,93,0,557,557,339,0,90,86,42,0,0
20101020,,金門縣,1,1,0,18,18,0,4,4,3,1,0,0,0,0,0,0,0,0,79,79,32,13,0,34,0,0,0,0,0,0,0,0
20101020,,連江縣,1,1,0,1,1,0,1,1,0,1,0,0,0,0,0,0,0,0,3,3,0,1,0,2,0,0,0,0,0,0,0,0
20110301,,台北市,54,36,18,372,119,253,159,62,27,35,0,97,70,0,12,9,6,0,4729,2084,377,692,0,1015,2645,1948,0,351,230,111,0,5
20110301,,高雄市,19,12,7,84,49,35,43,22,14,8,0,21,3,3,6,6,3,0,1671,1194,204,134,0,856,477,87,0,142,176,64,0,8
20110301,,台北縣,22,15,7,122,100,22,79,52,40,7,5,27,6,0,9,12,0,0,2265,1519,587,92,2,838,746,168,0,232,345,0,0,1
20110301,,宜蘭縣,10,7,3,103,29,74,31,16,9,7,0,15,6,0,3,3,3,0,873,543,131,131,0,281,330,172,0,68,42,47,0,1
20110301,,桃園縣,22,14,8,82,49,33,72,39,27,12,0,33,6,0,12,12,3,0,2057,1213,390,92,0,731,844,113,0,348,331,49,0,3
20110301,,新竹縣,6,5,1,16,15,1,17,14,10,4,0,3,0,0,0,0,3,0,423,368,133,47,0,188,55,0,0,0,0,55,0,0
20110301,,苗栗縣,7,5,2,24,24,0,22,16,11,5,0,6,0,0,6,0,0,0,664,513,153,97,0,263,151,0,0,151,0,0,0,0
20110301,,台中縣,17,15,2,61,55,6,49,43,28,15,0,6,0,0,3,3,0,0,1605,1428,425,262,0,741,177,0,0,89,87,0,0,1
20110301,,彰化縣,16,13,3,90,48,42,51,33,20,13,0,18,12,0,3,3,0,0,1544,1032,302,361,0,369,512,345,0,77,89,0,0,1
20110301,,南投縣,8,5,3,46,35,11,29,20,17,3,0,9,3,0,3,3,0,0,757,476,213,80,0,183,281,120,0,80,79,0,0,2
20110301,,雲林縣,8,5,3,67,17,50,32,20,15,5,0,12,6,0,3,3,0,0,808,533,200,22,0,311,275,142,0,78,53,0,0,2
20110301,,嘉義縣,2,2,0,8,8,0,6,6,6,0,0,0,0,0,0,0,0,0,318,318,72,0,0,246,0,0,0,0,0,0,0,0
20110301,,台南縣,13,11,2,64,48,16,37,31,21,10,0,6,0,0,6,0,0,0,1021,927,306,132,0,489,94,0,0,91,0,0,0,3
20110301,,高雄縣,9,6,3,48,34,14,32,20,15,5,0,12,3,0,3,6,0,0,1118,847,222,303,0,322,271,92,0,80,98,0,0,1
20110301,,屏東縣,9,7,2,80,40,40,41,26,20,6,0,15,9,0,3,3,0,0,995,570,257,76,0,237,425,263,0,81,79,0,0,2
20110301,,台東縣,5,4,1,19,15,4,12,9,7,2,0,3,0,0,3,0,0,0,327,277,88,12,0,177,50,0,0,50,0,0,0,0
20110301,,花蓮縣,6,4,2,40,13,27,28,13,9,4,0,15,9,0,3,3,0,0,680,333,110,26,3,194,347,249,0,52,46,0,0,0
20110301,,澎湖縣,2,1,1,17,11,6,11,5,4,1,0,6,0,0,3,3,0,0,109,68,32,11,0,25,41,0,0,24,17,0,0,0
20110301,,基隆市,4,3,1,19,16,3,15,9,6,3,0,6,0,0,3,3,0,0,409,254,88,34,0,132,155,0,0,79,75,0,0,1
20110301,,新竹市,8,5,3,47,35,12,40,19,14,4,1,21,15,0,3,3,0,0,1165,624,201,47,1,375,541,370,0,91,80,0,0,0
20110301,,台中市,14,8,6,127,35,92,62,20,12,7,1,42,24,0,3,12,3,0,1920,814,207,191,15,401,1106,681,0,88,279,58,0,0
20110301,,嘉義市,5,3,2,50,7,43,26,5,3,2,0,21,12,0,3,3,3,0,762,246,45,33,0,168,516,287,0,93,83,52,0,1
20110301,,台南市,12,8,4,51,13,38,32,11,3,8,0,21,12,0,3,3,3,0,1247,682,57,93,0,532,565,341,0,89,86,47,0,2
20110301,,金門縣,1,1,0,19,19,0,4,4,3,1,0,0,0,0,0,0,0,0,76,76,32,12,0,32,0,0,0,0,0,0,0,0
20110301,,連江縣,1,1,0,1,1,0,1,1,0,1,0,0,0,0,0,0,0,0,3,3,0,1,0,2,0,0,0,0,0,0,0,0
20110321,,臺北市,54,36,18,372,119,253,159,62,27,35,0,97,70,0,12,9,6,0,4733,2089,381,693,0,1015,2644,1948,0,351,230,111,0,4
20110321,,高雄市,28,18,10,132,83,49,75,42,29,13,0,33,6,3,9,12,3,0,2769,2032,425,437,0,1170,737,177,0,222,274,64,0,0
20110321,,新北市,22,15,7,120,100,20,79,52,40,7,5,27,6,0,9,12,0,0,2261,1516,586,92,2,836,745,168,0,232,345,0,0,0
20110321,,宜蘭縣,10,7,3,103,29,74,31,16,9,7,0,15,6,0,3,3,3,0,874,545,130,149,0,266,329,172,0,68,42,47,0,0
20110321,,桃園縣,22,14,8,80,49,31,72,39,27,12,0,33,6,0,12,12,3,0,2006,1209,390,91,0,728,797,113,0,332,303,49,0,0
20110321,,新竹縣,6,5,1,16,15,1,17,14,10,4,0,3,0,0,0,0,3,0,422,367,133,47,0,187,55,0,0,0,0,55,0,0
20110321,,苗栗縣,7,5,2,24,24,0,22,16,11,5,0,6,0,0,6,0,0,0,655,504,151,93,0,260,151,0,0,151,0,0,0,0
20110321,,彰化縣,16,13,3,90,48,42,51,33,20,13,0,18,12,0,3,3,0,0,1538,1027,302,358,0,367,511,345,0,77,89,0,0,0
20110321,,南投縣,8,5,3,46,35,11,29,20,17,3,0,9,3,0,3,3,0,0,758,479,213,80,0,186,279,120,0,80,79,0,0,0
20110321,,雲林縣,8,5,3,67,17,50,32,20,15,5,0,12,6,0,3,3,0,0,828,526,199,21,0,306,302,171,0,78,53,0,0,0
20110321,,嘉義縣,2,2,0,8,8,0,6,6,6,0,0,0,0,0,0,0,0,0,318,318,71,0,0,247,0,0,0,0,0,0,0,0
20110321,,屏東縣,9,7,2,80,40,40,41,26,20,6,0,15,9,0,3,3,0,0,992,569,255,76,0,238,423,263,0,81,79,0,0,0
20110321,,台東縣,5,4,1,19,15,4,12,9,7,2,0,3,0,0,3,0,0,0,327,277,88,13,0,176,50,0,0,50,0,0,0,0
20110321,,花蓮縣,6,4,2,40,13,27,28,13,9,4,0,15,9,0,3,3,0,0,679,332,110,26,3,193,347,249,0,52,46,0,0,0
20110321,,澎湖縣,2,1,1,17,11,6,11,5,4,1,0,6,0,0,3,3,0,0,108,67,32,10,0,25,41,0,0,24,17,0,0,0
20110321,,基隆市,4,3,1,19,16,3,15,9,6,3,0,6,0,0,3,3,0,0,410,256,88,34,0,134,154,0,0,79,75,0,0,0
20110321,,新竹市,8,5,3,47,35,12,40,19,14,4,1,21,15,0,3,3,0,0,1166,625,201,47,1,376,541,370,0,91,80,0,0,0
20110321,,臺中市,31,23,8,188,90,98,111,63,40,22,1,48,24,0,6,15,3,0,3526,2244,628,453,15,1148,1282,681,0,177,366,58,0,0
20110321,,嘉義市,5,3,2,50,7,43,26,5,3,2,0,21,12,0,3,3,3,0,799,226,45,28,0,153,573,345,0,93,83,52,0,0
20110321,,臺南市,25,19,6,111,61,50,69,42,24,18,0,27,12,0,9,3,3,0,2256,1602,358,225,0,1019,654,341,0,180,86,47,0,0
20110321,,金門縣,1,1,0,19,19,0,4,4,3,1,0,0,0,0,0,0,0,0,77,77,32,12,0,33,0,0,0,0,0,0,0,0
20110321,,連江縣,1,1,0,1,1,0,1,1,0,1,0,0,0,0,0,0,0,0,4,4,0,3,0,1,0,0,0,0,0,0,0,0
20110530,,臺北市,54,36,18,352,119,233,159,62,27,35,0,97,70,0,12,9,6,0,4715,2069,381,687,0,1001,2646,1951,0,351,230,110,0,4
20110530,,高雄市,27,18,9,132,83,49,72,42,29,13,0,30,6,0,9,12,3,0,2762,2025,423,436,0,1166,737,177,0,222,274,64,0,0
20110530,,新北市,21,14,7,118,99,19,79,52,40,7,5,27,6,0,9,12,0,0,2251,1508,586,91,2,829,743,168,0,232,343,0,0,0
20110530,,宜蘭縣,10,7,3,98,29,69,31,16,9,7,0,15,6,0,3,3,3,0,874,545,130,151,0,264,329,172,0,68,42,47,0,0
20110530,,桃園縣,22,14,8,78,49,29,72,39,27,12,0,33,6,0,12,12,3,0,2066,1208,389,92,0,727,858,173,0,332,304,49,0,0
20110530,,新竹縣,6,5,1,16,15,1,17,14,10,4,0,3,0,0,0,0,3,0,421,366,133,47,0,186,55,0,0,0,0,55,0,0
20110530,,苗栗縣,7,5,2,21,21,0,22,16,11,5,0,6,0,0,6,0,0,0,648,498,149,94,0,255,150,0,0,150,0,0,0,0
20110530,,彰化縣,16,13,3,89,48,41,51,33,20,13,0,18,12,0,3,3,0,0,1540,1027,302,358,0,367,513,347,0,77,89,0,0,0
20110530,,南投縣,8,5,3,43,35,8,29,20,17,3,0,9,3,0,3,3,0,0,750,471,210,79,0,182,279,120,0,80,79,0,0,0
20110530,,雲林縣,8,5,3,67,17,50,32,20,15,5,0,12,6,0,3,3,0,0,826,524,198,21,0,305,302,171,0,78,53,0,0,0
20110530,,嘉義縣,2,2,0,9,9,0,6,6,6,0,0,0,0,0,0,0,0,0,315,315,72,0,0,243,0,0,0,0,0,0,0,0
20110530,,屏東縣,9,7,2,79,39,40,41,26,20,6,0,15,9,0,3,3,0,0,985,562,254,72,0,236,423,263,0,81,79,0,0,0
20110530,,台東縣,5,4,1,19,15,4,12,9,7,2,0,3,0,0,3,0,0,0,321,271,88,13,0,170,50,0,0,50,0,0,0,0
20110530,,花蓮縣,6,4,2,40,13,27,28,13,9,4,0,15,9,0,3,3,0,0,675,328,110,26,3,189,347,249,0,52,46,0,0,0
20110530,,澎湖縣,2,1,1,17,11,6,11,5,4,1,0,6,0,0,3,3,0,0,108,67,32,10,0,25,41,0,0,24,17,0,0,0
20110530,,基隆市,4,3,1,19,16,3,15,9,6,3,0,6,0,0,3,3,0,0,413,257,87,34,0,136,156,0,0,79,77,0,0,0
20110530,,新竹市,8,5,3,47,35,12,40,19,14,4,1,21,15,0,3,3,0,0,1212,615,201,46,1,367,597,426,0,91,80,0,0,0
20110530,,臺中市,32,23,9,189,90,99,112,63,40,22,1,49,25,0,6,15,3,0,3519,2237,628,450,15,1144,1282,681,0,177,366,58,0,0
20110530,,嘉義市,5,3,2,50,7,43,26,5,3,2,0,21,12,0,3,3,3,0,796,224,44,28,0,152,572,345,0,93,83,51,0,0
20110530,,臺南市,25,19,6,111,63,48,69,42,24,18,0,27,12,0,9,3,3,0,2257,1603,357,225,0,1021,654,341,0,180,86,47,0,0
20110530,,金門縣,1,1,0,19,19,0,4,4,3,1,0,0,0,0,0,0,0,0,80,80,33,12,1,34,0,0,0,0,0,0,0,0
20110530,,連江縣,1,1,0,1,1,0,1,1,0,1,0,0,0,0,0,0,0,0,4,4,0,3,0,1,0,0,0,0,0,0,0,0
20131021,,新北市,27,19,8,153,126,27,95,67,50,11,6,28,6,10,12,0,0,0,2743,1986,648,468,41,829,757,179,264,314,0,0,0,0
20131021,,臺北市,54,36,18,316,143,173,165,67,27,40,0,98,69,12,9,6,0,2,5374,2792,376,1333,21,1062,2582,1891,310,248,111,0,22,0
20131021,,臺中市,33,24,9,166,118,48,113,67,44,22,1,46,26,6,11,3,0,0,3500,2255,617,1206,28,404,1245,748,197,256,44,0,0,0
20131021,,臺南市,28,22,6,130,74,56,74,47,27,19,1,27,12,9,3,3,0,0,2429,1778,381,861,0,536,651,360,151,81,59,0,0,0
20131021,,高雄市,29,19,10,140,87,53,83,51,35,16,0,32,6,9,12,3,2,0,3042,2349,489,609,2,1249,693,169,196,245,58,25,0,0
20131021,,宜蘭縣,11,8,3,70,29,41,31,16,9,7,0,15,6,3,3,3,0,0,802,499,107,372,0,20,303,136,72,43,52,0,0,0
20131021,,桃園縣,27,19,8,102,63,39,80,47,30,17,0,33,6,12,12,3,0,0,2572,1844,457,833,0,554,728,113,278,275,62,0,0,0
20131021,,新竹縣,6,5,1,23,22,1,20,17,12,5,0,3,0,0,0,3,0,0,566,516,155,239,0,122,50,0,0,0,50,0,0,0
20131021,,苗栗縣,8,6,2,37,32,5,25,19,14,5,0,6,0,6,0,0,0,0,812,674,157,321,0,196,138,0,138,0,0,0,0,0
20131021,,彰化縣,16,13,3,86,60,26,55,37,24,13,0,18,12,3,3,0,0,0,1660,1115,341,702,0,72,545,392,71,82,0,0,0,0
20131021,,南投縣,9,6,3,43,36,7,33,21,17,4,0,12,6,3,3,0,0,0,865,550,220,119,0,211,315,171,72,72,0,0,0,0
20131021,,雲林縣,9,6,3,69,30,39,33,21,15,6,0,12,6,3,3,0,0,0,977,664,192,243,0,229,313,170,94,49,0,0,0,0
20131021,,嘉義縣,2,2,0,6,6,0,5,5,4,1,0,0,0,0,0,0,0,0,376,376,48,42,0,286,0,0,0,0,0,0,0,0
20131021,,屏東縣,10,8,2,74,36,38,40,25,18,6,1,15,9,3,3,0,0,0,934,529,211,150,0,168,405,262,82,61,0,0,0,0
20131021,,臺東縣,5,4,1,16,12,4,12,9,7,2,0,3,0,3,0,0,0,0,363,290,73,87,0,130,73,0,73,0,0,0,0,0
20131021,,花蓮縣,6,4,2,39,16,23,28,13,9,4,0,15,9,3,3,0,0,0,776,433,106,172,1,154,343,229,61,53,0,0,0,0
20131021,,澎湖縣,2,1,1,17,10,7,11,5,4,1,0,6,0,3,3,0,0,0,120,73,37,29,0,7,47,0,30,17,0,0,0,0
20131021,,基隆市,4,3,1,23,17,6,15,9,6,3,0,6,0,3,3,0,0,0,420,279,84,99,0,96,141,0,73,68,0,0,0,0
20131021,,新竹市,10,7,3,128,23,105,39,18,12,6,0,21,15,3,3,0,0,0,1260,698,152,311,0,235,562,391,90,81,0,0,0,0
20131021,,嘉義市,6,4,2,53,14,39,29,8,4,4,0,21,12,3,3,3,0,0,820,371,53,230,0,88,449,235,88,87,39,0,0,0
20131021,,金門縣,1,1,0,7,7,0,4,4,3,1,0,0,0,0,0,0,0,0,76,76,33,38,0,5,0,0,0,0,0,0,0,0
20131021,,連江縣,1,1,0,1,1,0,1,1,0,1,0,0,0,0,0,0,0,0,11,11,0,11,0,0,0,0,0,0,0,0,0,0
20140320,,新北市,27,19,8,152,126,26,95,67,50,11,6,28,6,10,12,0,0,0,2734,1984,649,467,92,776,750,179,263,308,0,0,0,0
20140320,,臺北市,54,36,18,315,142,173,165,67,27,40,0,98,69,12,9,6,0,2,5293,2749,373,1317,20,1039,2544,1859,311,245,110,0,19,0
20140320,,臺中市,33,24,9,179,120,59,113,67,44,22,1,46,26,6,11,3,0,0,3455,2214,605,1227,27,355,1241,753,170,256,62,0,0,0
20140320,,臺南市,28,22,6,129,74,55,74,47,27,19,1,27,12,9,3,3,0,0,2395,1766,381,908,0,477,629,340,150,80,59,0,0,0
20140320,,高雄市,29,19,10,250,194,56,83,51,35,16,0,32,6,9,12,3,2,0,3031,2328,494,576,4,1254,703,166,196,245,57,39,0,0
20140320,,宜蘭縣,11,8,3,71,30,41,31,16,9,7,0,15,6,3,3,3,0,0,808,487,109,357,0,21,321,155,71,45,50,0,0,0
20140320,,桃園縣,27,19,8,113,70,43,80,47,30,17,0,33,6,12,12,3,0,0,2636,1795,412,867,0,516,841,174,336,270,61,0,0,0
20140320,,新竹縣,6,5,1,26,25,1,20,17,12,5,0,3,0,0,0,3,0,0,561,511,153,262,0,96,50,0,0,0,50,0,0,0
20140320,,苗栗縣,8,6,2,38,33,5,25,19,14,5,0,6,0,6,0,0,0,0,801,663,163,320,0,180,138,0,138,0,0,0,0,0
20140320,,彰化縣,16,13,3,91,63,28,55,37,24,13,0,18,12,3,3,0,0,0,1562,1079,342,676,0,61,483,331,71,81,0,0,0,0
20140320,,南投縣,9,6,3,49,36,13,33,21,17,4,0,12,6,3,3,0,0,0,838,526,211,114,0,201,312,171,69,72,0,0,0,0
20140320,,雲林縣,9,6,3,69,29,40,33,21,15,6,0,12,6,3,3,0,0,0,939,634,197,225,0,212,305,178,79,48,0,0,0,0
20140320,,嘉義縣,2,2,0,9,9,0,5,5,4,1,0,0,0,0,0,0,0,0,375,375,47,42,0,286,0,0,0,0,0,0,0,0
20140320,,屏東縣,10,8,2,91,38,53,40,25,18,6,1,15,9,3,3,0,0,0,921,517,203,146,0,168,404,261,82,61,0,0,0,0
20140320,,臺東縣,5,4,1,18,14,4,12,9,7,2,0,3,0,3,0,0,0,0,349,285,74,82,0,129,64,0,64,0,0,0,0,0
20140320,,花蓮縣,6,4,2,66,19,47,28,13,9,4,0,15,9,3,3,0,0,0,743,401,107,151,1,142,342,230,61,51,0,0,0,0
20140320,,澎湖縣,2,1,1,17,10,7,11,5,4,1,0,6,0,3,3,0,0,0,120,74,36,29,0,9,46,0,29,17,0,0,0,0
20140320,,基隆市,4,3,1,23,17,6,15,9,6,3,0,6,0,3,3,0,0,0,418,273,82,103,0,88,145,0,75,70,0,0,0,0
20140320,,新竹市,10,7,3,128,23,105,39,18,12,6,0,21,15,3,3,0,0,0,1241,682,150,288,0,244,559,390,90,79,0,0,0,0
20140320,,嘉義市,6,4,2,54,15,39,29,8,4,4,0,21,12,3,3,3,0,0,803,341,53,206,0,82,462,230,88,87,57,0,0,0
20140320,,金門縣,1,1,0,7,7,0,4,4,3,1,0,0,0,0,0,0,0,0,74,74,34,35,0,5,0,0,0,0,0,0,0,0
20140320,,連江縣,1,1,0,1,1,0,1,1,0,1,0,0,0,0,0,0,0,0,12,12,0,11,0,1,0,0,0,0,0,0,0,0
20140528,,新北市,25,18,7,168,133,35,93,66,50,10,6,27,6,9,12,0,0,0,2730,1981,649,406,92,834,749,179,263,307,0,0,0,0
20140528,,臺北市,54,36,18,317,142,175,165,67,27,40,0,98,69,12,9,6,0,2,5227,2698,372,1294,20,1012,2529,1848,312,246,104,0,19,0
20140528,,臺中市,33,24,9,176,118,58,113,67,44,22,1,46,26,6,11,3,0,0,3302,2061,595,1124,26,316,1241,752,170,257,62,0,0,0
20140528,,臺南市,28,22,6,131,77,54,74,47,27,19,1,27,12,9,3,3,0,0,2333,1704,376,871,0,457,629,340,150,80,59,0,0,0
20140528,,高雄市,29,19,10,164,108,56,83,51,35,16,0,32,6,9,12,3,2,0,3021,2318,493,571,5,1249,703,166,196,245,57,39,0,0
20140528,,宜蘭縣,11,8,3,70,29,41,31,16,9,7,0,15,6,3,3,3,0,0,786,464,106,335,0,23,322,155,71,46,50,0,0,0
20140528,,桃園縣,27,19,8,111,70,41,80,47,30,17,0,33,6,12,12,3,0,0,2553,1710,414,809,0,487,843,175,337,270,61,0,0,0
20140528,,新竹縣,6,5,1,25,24,1,20,17,12,5,0,3,0,0,0,3,0,0,526,477,154,234,0,89,49,0,0,0,49,0,0,0
20140528,,苗栗縣,8,6,2,51,46,5,25,19,14,5,0,6,0,6,0,0,0,0,786,647,163,302,0,182,139,0,139,0,0,0,0,0
20140528,,彰化縣,16,13,3,91,63,28,55,37,24,13,0,18,12,3,3,0,0,0,1449,964,313,591,0,60,485,331,71,83,0,0,0,0
20140528,,南投縣,9,6,3,49,36,13,33,21,17,4,0,12,6,3,3,0,0,0,830,519,210,112,0,197,311,170,69,72,0,0,0,0
20140528,,雲林縣,9,6,3,70,30,40,33,21,15,6,0,12,6,3,3,0,0,0,886,581,198,201,0,182,305,178,79,48,0,0,0,0
20140528,,嘉義縣,2,2,0,11,11,0,5,5,4,1,0,0,0,0,0,0,0,0,326,326,46,32,0,248,0,0,0,0,0,0,0,0
20140528,,屏東縣,10,8,2,91,38,53,40,25,18,6,1,15,9,3,3,0,0,0,911,507,205,142,1,159,404,261,82,61,0,0,0,0
20140528,,臺東縣,5,4,1,18,14,4,12,9,7,2,0,3,0,3,0,0,0,0,337,274,74,75,0,125,63,0,63,0,0,0,0,0
20140528,,花蓮縣,6,4,2,65,18,47,28,13,9,4,0,15,9,3,3,0,0,0,721,379,108,136,1,134,342,230,61,51,0,0,0,0
20140528,,澎湖縣,2,1,1,17,10,7,11,5,4,1,0,6,0,3,3,0,0,0,112,66,36,21,0,9,46,0,29,17,0,0,0,0
20140528,,基隆市,4,3,1,23,17,6,15,9,6,3,0,6,0,3,3,0,0,0,411,268,84,102,0,82,143,0,73,70,0,0,0,0
20140528,,新竹市,10,7,3,129,26,103,39,18,12,6,0,21,15,3,3,0,0,0,1229,669,151,282,0,236,560,390,91,79,0,0,0,0
20140528,,嘉義市,6,4,2,54,15,39,29,8,4,4,0,21,12,3,3,3,0,0,896,320,53,190,0,77,576,346,87,87,56,0,0,0
20140528,,金門縣,1,1,0,7,7,0,4,4,3,1,0,0,0,0,0,0,0,0,65,65,34,27,0,4,0,0,0,0,0,0,0,0
20140528,,連江縣,1,1,0,1,1,0,1,1,0,1,0,0,0,0,0,0,0,0,10,10,0,9,0,1,0,0,0,0,0,0,0,0
20141020,,新北市,25,17,8,183,143,40,97,69,53,10,6,28,6,10,12,0,0,0,2919,2133,653,332,69,1079,786,176,291,319,0,0,0,0
20141020,,臺北市,53,36,17,322,141,181,164,67,27,40,0,97,68,12,9,6,0,2,5306,2779,379,1353,11,1036,2527,1842,303,255,120,0,7,0
20141020,,臺中市,32,24,8,162,116,46,113,68,45,22,1,45,27,6,9,3,0,0,3274,2069,600,1131,30,308,1205,736,177,225,67,0,0,0
20141020,,臺南市,29,23,6,130,79,51,74,48,27,20,1,26,12,8,3,3,0,0,2425,1776,375,981,2,418,649,353,151,79,66,0,0,0
20141020,,高雄市,30,20,10,155,98,57,85,54,37,17,0,31,5,9,11,3,3,0,3128,2414,487,598,33,1296,714,145,215,249,56,49,0,0
20141020,,宜蘭縣,11,8,3,71,30,41,31,16,9,7,0,15,6,3,3,3,0,0,818,497,102,377,0,18,321,148,76,42,55,0,0,0
20141020,,桃園縣,28,20,8,105,70,35,79,48,30,18,0,31,6,12,10,3,0,0,2716,1923,403,964,2,554,793,112,370,251,60,0,0,0
20141020,,新竹縣,6,5,1,24,23,1,20,17,12,5,0,3,0,0,0,3,0,0,575,526,156,278,0,92,49,0,0,0,49,0,0,0
20141020,,苗栗縣,8,6,2,50,45,5,25,19,14,5,0,6,0,6,0,0,0,0,908,762,147,387,0,228,146,0,146,0,0,0,0,0
20141020,,彰化縣,16,13,3,78,64,14,55,37,24,13,0,18,12,3,3,0,0,0,1520,1047,307,681,0,59,473,318,73,82,0,0,0,0
20141020,,南投縣,10,7,3,50,37,13,34,22,17,5,0,12,6,3,3,0,0,0,832,522,185,143,0,194,310,160,77,73,0,0,0,0
20141020,,雲林縣,9,6,3,50,28,22,33,21,15,6,0,12,6,3,3,0,0,0,962,659,195,238,0,226,303,174,78,51,0,0,0,0
20141020,,嘉義縣,2,2,0,12,12,0,6,6,5,1,0,0,0,0,0,0,0,0,361,361,52,37,0,272,0,0,0,0,0,0,0,0
20141020,,屏東縣,10,8,2,91,39,52,40,25,18,6,1,15,9,3,3,0,0,0,973,599,206,187,3,203,374,245,69,60,0,0,0,0
20141020,,臺東縣,5,4,1,17,13,4,11,8,6,2,0,3,0,3,0,0,0,0,334,273,74,80,0,119,61,0,61,0,0,0,0,0
20141020,,花蓮縣,6,4,2,63,18,45,28,13,9,4,0,15,9,3,3,0,0,0,723,416,107,149,1,159,307,213,50,44,0,0,0,0
20141020,,澎湖縣,2,1,1,18,10,8,11,5,4,1,0,6,0,3,3,0,0,0,116,70,35,28,0,7,46,0,35,11,0,0,0,0
20141020,,基隆市,4,3,1,20,17,3,15,9,6,3,0,6,0,3,3,0,0,0,397,270,85,106,0,79,127,0,57,70,0,0,0,0
20141020,,新竹市,10,7,3,138,28,110,39,18,12,6,0,21,15,3,3,0,0,0,1341,763,135,320,2,306,578,403,93,82,0,0,0,0
20141020,,嘉義市,6,4,2,56,19,37,30,9,5,4,0,21,12,3,3,3,0,0,805,354,66,219,0,69,451,227,84,84,56,0,0,0
20141020,,金門縣,1,1,0,7,7,0,4,4,3,1,0,0,0,0,0,0,0,0,68,68,27,33,0,8,0,0,0,0,0,0,0,0
20141020,,連江縣,1,1,0,1,1,0,1,1,0,1,0,0,0,0,0,0,0,0,11,11,0,11,0,0,0,0,0,0,0,0,0,0
20150320,,新北市,25,17,8,182,142,40,97,69,53,10,6,28,6,10,12,0,0,0,2897,2118,653,292,124,1049,779,176,287,316,0,0,0,0
20150320,,臺北市,53,36,17,327,147,180,164,67,27,40,0,97,68,12,9,6,0,2,5331,2733,378,1342,10,1003,2598,1853,332,254,120,0,39,0
20150320,,臺中市,32,24,8,175,126,49,113,68,45,22,1,45,27,6,9,3,0,0,3090,1890,551,1031,30,278,1200,736,173,224,67,0,0,0
20150320,,臺南市,29,23,6,132,81,51,74,48,27,20,1,26,12,8,3,3,0,0,2407,1756,375,967,2,412,651,352,154,79,66,0,0,0
20150320,,高雄市,30,20,10,155,99,56,85,54,37,17,0,31,5,9,11,3,3,0,3084,2374,491,703,13,1167,710,145,214,246,56,49,0,0
20150320,,宜蘭縣,11,8,3,70,29,41,31,16,9,7,0,15,6,3,3,3,0,0,797,478,99,360,0,19,319,148,75,41,55,0,0,0
20150320,,桃園市,28,20,8,109,73,36,79,48,30,18,0,31,6,12,10,3,0,0,2751,1902,407,943,2,550,849,170,369,250,60,0,0,0
20150320,,新竹縣,6,5,1,24,23,1,20,17,12,5,0,3,0,0,0,3,0,0,558,510,157,260,0,93,48,0,0,0,48,0,0,0
20150320,,苗栗縣,8,6,2,48,44,4,25,19,14,5,0,6,0,6,0,0,0,0,884,738,148,371,0,219,146,0,146,0,0,0,0,0
20150320,,彰化縣,16,13,3,81,64,17,55,37,24,13,0,18,12,3,3,0,0,0,1476,1005,309,638,0,58,471,316,73,82,0,0,0,0
20150320,,南投縣,10,7,3,50,37,13,34,22,17,5,0,12,6,3,3,0,0,0,797,487,182,137,0,168,310,160,77,73,0,0,0,0
20150320,,雲林縣,9,6,3,57,28,29,33,21,15,6,0,12,6,3,3,0,0,0,936,633,202,225,0,206,303,175,77,51,0,0,0,0
20150320,,嘉義縣,2,2,0,12,12,0,6,6,5,1,0,0,0,0,0,0,0,0,330,330,53,36,0,241,0,0,0,0,0,0,0,0
20150320,,屏東縣,10,8,2,87,40,47,40,25,18,6,1,15,9,3,3,0,0,0,958,584,207,183,5,189,374,245,69,60,0,0,0,0
20150320,,臺東縣,5,4,1,17,13,4,11,8,6,2,0,3,0,3,0,0,0,0,326,265,73,79,0,113,61,0,61,0,0,0,0,0
20150320,,花蓮縣,6,4,2,64,19,45,28,13,9,4,0,15,9,3,3,0,0,0,710,403,109,134,1,159,307,213,50,44,0,0,0,0
20150320,,澎湖縣,2,1,1,18,10,8,11,5,4,1,0,6,0,3,3,0,0,0,105,59,35,20,0,4,46,0,35,11,0,0,0,0
20150320,,基隆市,4,3,1,20,17,3,15,9,6,3,0,6,0,3,3,0,0,0,402,276,81,108,0,87,126,0,56,70,0,0,0,0
20150320,,新竹市,10,7,3,138,28,110,39,18,12,6,0,21,15,3,3,0,0,0,1327,748,135,308,2,303,579,404,93,82,0,0,0,0
20150320,,嘉義市,6,4,2,59,19,40,30,9,5,4,0,21,12,3,3,3,0,0,912,346,65,211,0,70,566,344,84,82,56,0,0,0
20150320,,金門縣,1,1,0,7,7,0,4,4,3,1,0,0,0,0,0,0,0,0,61,61,28,24,0,9,0,0,0,0,0,0,0,0
20150320,,連江縣,1,1,0,1,1,0,1,1,0,1,0,0,0,0,0,0,0,0,11,11,0,11,0,0,0,0,0,0,0,0,0,0
20150528,,新北市,25,17,8,196,151,45,97,69,53,10,6,28,6,10,12,0,0,0,2885,2106,650,285,121,1050,779,176,287,316,0,0,0,0
20150528,,臺北市,53,36,17,328,147,181,164,67,27,40,0,97,68,12,9,6,0,2,5346,2727,376,1333,10,1008,2619,1853,332,255,127,0,52,0
20150528,,臺中市,32,24,8,174,125,49,113,68,45,22,1,45,27,6,9,3,0,0,2988,1788,515,950,30,293,1200,735,173,225,67,0,0,0
20150528,,臺南市,29,23,6,132,81,51,74,48,27,20,1,26,12,8,3,3,0,0,2385,1735,378,946,2,409,650,352,153,79,66,0,0,0
20150528,,高雄市,30,20,10,156,99,57,85,54,37,17,0,31,5,9,11,3,3,0,3061,2350,487,697,25,1141,711,145,214,247,56,49,0,0
20150528,,宜蘭縣,11,8,3,71,30,41,31,16,9,7,0,15,6,3,3,3,0,0,790,470,98,351,0,21,320,148,76,41,55,0,0,0
20150528,,桃園市,28,20,8,105,73,32,79,48,30,18,0,31,6,12,10,3,0,0,2729,1878,405,928,2,543,851,172,369,250,60,0,0,0
20150528,,新竹縣,6,5,1,24,23,1,20,17,12,5,0,3,0,0,0,3,0,0,539,494,157,242,0,95,45,0,0,0,45,0,0,0
20150528,,苗栗縣,8,6,2,48,44,4,25,19,14,5,0,6,0,6,0,0,0,0,869,723,148,360,0,215,146,0,146,0,0,0,0,0
20150528,,彰化縣,16,13,3,81,64,17,55,37,24,13,0,18,12,3,3,0,0,0,1415,944,306,582,0,56,471,316,73,82,0,0,0,0
20150528,,南投縣,10,7,3,51,38,13,34,22,17,5,0,12,6,3,3,0,0,0,757,446,177,133,0,136,311,159,79,73,0,0,0,0
20150528,,雲林縣,9,6,3,57,28,29,33,21,15,6,0,12,6,3,3,0,0,0,933,630,201,216,0,213,303,175,77,51,0,0,0,0
20150528,,嘉義縣,2,2,0,13,13,0,6,6,5,1,0,0,0,0,0,0,0,0,306,306,53,30,0,223,0,0,0,0,0,0,0,0
20150528,,屏東縣,10,8,2,87,40,47,40,25,18,6,1,15,9,3,3,0,0,0,954,580,206,183,6,185,374,245,69,60,0,0,0,0
20150528,,臺東縣,5,4,1,17,13,4,11,8,6,2,0,3,0,3,0,0,0,0,324,263,72,79,0,112,61,0,61,0,0,0,0,0
20150528,,花蓮縣,6,4,2,64,19,45,28,13,9,4,0,15,9,3,3,0,0,0,685,378,109,125,1,143,307,213,50,44,0,0,0,0
20150528,,澎湖縣,2,1,1,18,10,8,11,5,4,1,0,6,0,3,3,0,0,0,108,62,37,20,0,5,46,0,35,11,0,0,0,0
20150528,,基隆市,4,3,1,20,17,3,15,9,6,3,0,6,0,3,3,0,0,0,408,282,81,105,0,96,126,0,56,70,0,0,0,0
20150528,,新竹市,10,7,3,138,28,110,39,18,12,6,0,21,15,3,3,0,0,0,1308,737,133,297,2,305,571,396,93,82,0,0,0,0
20150528,,嘉義市,6,4,2,64,19,45,30,9,5,4,0,21,12,3,3,3,0,0,888,322,64,189,0,69,566,344,84,82,56,0,0,0
20150528,,金門縣,1,1,0,7,7,0,4,4,3,1,0,0,0,0,0,0,0,0,60,60,28,25,0,7,0,0,0,0,0,0,0,0
20150528,,連江縣,1,1,0,1,1,0,1,1,0,1,0,0,0,0,0,0,0,0,12,12,0,12,0,0,0,0,0,0,0,0,0,0
20151021,,新北市,26,17,9,184,154,30,101,71,55,10,6,30,6,11,12,1,0,0,3129,2346,667,353,15,1311,783,118,353,288,23,0,0,1
20151021,,臺北市,54,37,17,333,149,184,165,69,28,41,0,96,67,12,9,6,0,2,5520,2797,365,1362,0,1070,2723,1932,340,288,134,0,29,0
20151021,,臺中市,33,25,8,174,126,48,114,69,45,22,2,45,27,6,9,3,0,0,3217,1942,532,1078,27,305,1275,775,208,212,70,0,0,10
20151021,,臺南市,29,23,6,131,81,50,73,48,27,20,1,25,12,7,3,3,0,0,2469,1813,374,1019,1,419,656,360,144,80,72,0,0,0
20151021,,高雄市,35,25,10,145,99,46,94,65,37,28,0,29,4,9,10,3,3,0,3150,2455,464,885,1,1105,695,90,252,257,62,26,0,8
20151021,,宜蘭縣,10,7,3,70,29,41,31,16,9,7,0,15,6,3,3,3,0,0,839,501,94,385,0,22,338,128,79,70,61,0,0,0
20151021,,桃園市,29,21,8,126,72,54,81,50,32,18,0,31,6,12,10,3,0,0,3259,2434,430,1276,0,728,825,122,382,260,61,0,0,0
20151021,,新竹縣,6,5,1,23,22,1,20,17,12,5,0,3,0,0,0,3,0,0,613,554,152,287,0,115,59,0,0,0,59,0,0,0
20151021,,苗栗縣,9,7,2,48,43,5,26,20,14,6,0,6,0,6,0,0,0,0,965,807,151,417,0,239,158,0,158,0,0,0,0,0
20151021,,彰化縣,16,13,3,80,62,18,55,37,24,13,0,18,12,3,3,0,0,0,1433,1051,316,649,4,82,382,213,84,84,0,0,0,1
20151021,,南投縣,10,7,3,49,36,13,33,21,16,5,0,12,6,3,3,0,0,0,787,494,168,155,0,171,293,118,101,74,0,0,0,0
20151021,,雲林縣,9,6,3,57,29,28,34,22,16,6,0,12,6,3,3,0,0,0,977,699,200,263,0,236,278,178,50,50,0,0,0,0
20151021,,嘉義縣,2,2,0,13,13,0,6,6,5,1,0,0,0,0,0,0,0,0,303,303,50,26,0,227,0,0,0,0,0,0,0,0
20151021,,屏東縣,11,9,2,88,42,46,42,27,19,7,1,15,9,3,3,0,0,0,998,635,222,235,2,176,363,232,73,57,0,0,0,1
20151021,,臺東縣,6,5,1,17,14,3,12,9,6,3,0,3,0,3,0,0,0,0,352,282,68,94,0,120,70,0,70,0,0,0,0,0
20151021,,花蓮縣,7,5,2,61,20,41,29,14,9,5,0,15,9,3,3,0,0,0,679,429,105,169,0,155,250,143,58,48,0,0,0,1
20151021,,澎湖縣,2,1,1,18,10,8,11,5,4,1,0,6,0,3,3,0,0,0,111,63,30,28,0,5,48,0,36,12,0,0,0,0
20151021,,基隆市,4,3,1,20,17,3,15,9,6,3,0,6,0,3,3,0,0,0,441,293,78,115,0,100,148,0,68,78,0,0,0,2
20151021,,新竹市,11,8,3,154,29,125,40,19,12,7,0,21,15,3,3,0,0,0,1388,860,139,347,0,374,528,353,94,81,0,0,0,0
20151021,,嘉義市,6,4,2,68,21,47,31,10,6,4,0,21,12,3,3,3,0,0,904,370,79,223,0,68,534,297,87,86,64,0,0,0
20151021,,金門縣,1,1,0,7,7,0,4,4,3,1,0,0,0,0,0,0,0,0,66,66,22,34,0,10,0,0,0,0,0,0,0,0
20151021,,連江縣,1,1,0,1,1,0,1,1,0,1,0,0,0,0,0,0,0,0,14,14,0,14,0,0,0,0,0,0,0,0,0,0
20160321,,新北市,26,17,9,177,147,30,101,71,55,10,6,30,6,11,12,1,0,0,3097,2301,657,371,125,1148,796,176,319,278,22,0,0,1
20160321,,臺北市,54,37,17,315,148,167,165,69,28,41,0,96,67,12,9,6,0,2,5343,2773,365,1360,0,1048,2570,1817,332,255,127,0,39,0
20160321,,臺中市,33,25,8,188,137,51,114,69,45,22,2,45,27,6,9,3,0,0,2991,1782,509,978,26,269,1209,730,178,233,68,0,0,0
20160321,,臺南市,29,23,6,140,82,58,73,48,27,20,1,25,12,7,3,3,0,0,2377,1714,363,968,6,377,663,349,164,79,71,0,0,0
20160321,,高雄市,35,25,10,153,111,42,93,64,36,28,0,29,4,9,10,3,3,0,3021,2302,472,831,20,979,719,117,245,249,59,49,0,0
20160321,,宜蘭縣,10,7,3,72,31,41,31,16,9,7,0,15,6,3,3,3,0,0,776,454,88,346,0,20,322,142,76,47,57,0,0,0
20160321,,桃園市,28,21,7,123,73,50,80,50,32,18,0,30,6,12,9,3,0,0,3094,2334,417,1237,1,679,760,112,344,245,59,0,0,0
20160321,,新竹縣,6,5,1,25,24,1,20,17,12,5,0,3,0,0,0,3,0,0,562,509,149,250,0,110,53,0,0,0,53,0,0,0
20160321,,苗栗縣,9,7,2,42,36,6,26,20,14,6,0,6,0,6,0,0,0,0,945,793,154,409,0,230,152,0,152,0,0,0,0,0
20160321,,彰化縣,16,13,3,85,64,21,55,37,24,13,0,18,12,3,3,0,0,0,1459,978,314,591,0,73,481,315,82,84,0,0,0,0
20160321,,南投縣,10,7,3,49,36,13,33,21,16,5,0,12,6,3,3,0,0,0,782,470,166,151,0,153,312,161,78,73,0,0,0,0
20160321,,雲林縣,9,6,3,57,29,28,34,22,16,6,0,12,6,3,3,0,0,0,965,673,207,238,0,228,292,167,75,50,0,0,0,0
20160321,,嘉義縣,2,2,0,13,13,0,6,6,5,1,0,0,0,0,0,0,0,0,285,285,50,26,0,209,0,0,0,0,0,0,0,0
20160321,,屏東縣,11,9,2,98,40,58,42,27,19,7,1,15,9,3,3,0,0,0,989,617,222,227,6,162,372,249,70,53,0,0,0,0
20160321,,臺東縣,6,5,1,18,15,3,12,9,6,3,0,3,0,3,0,0,0,0,315,254,63,90,0,101,61,0,61,0,0,0,0,0
20160321,,花蓮縣,7,5,2,61,20,41,29,14,9,5,0,15,9,3,3,0,0,0,704,400,102,155,0,143,304,204,57,43,0,0,0,0
20160321,,澎湖縣,2,1,1,18,10,8,11,5,4,1,0,6,0,3,3,0,0,0,104,58,31,23,0,4,46,0,36,10,0,0,0,0
20160321,,基隆市,4,3,1,22,18,4,15,9,6,3,0,6,0,3,3,0,0,0,429,281,76,113,0,92,148,0,69,79,0,0,0,0
20160321,,新竹市,11,8,3,73,30,43,40,19,12,7,0,21,15,3,3,0,0,0,1330,775,137,326,0,312,555,380,94,81,0,0,0,0
20160321,,嘉義市,6,4,2,68,21,47,31,10,6,4,0,21,12,3,3,3,0,0,881,352,80,209,0,63,529,298,86,81,64,0,0,0
20160321,,金門縣,1,1,0,7,7,0,4,4,3,1,0,0,0,0,0,0,0,0,66,66,22,34,0,10,0,0,0,0,0,0,0,0
20160321,,連江縣,1,1,0,1,1,0,1,1,0,1,0,0,0,0,0,0,0,0,14,14,0,14,0,0,0,0,0,0,0,0,0,0
20160530,,新北市,26,17,9,176,147,29,101,71,55,10,6,30,6,11,12,1,0,0,3093,2297,657,385,108,1147,796,176,319,278,22,0,0,1
20160530,,臺北市,54,37,17,317,148,169,165,69,28,41,0,96,67,12,9,6,0,2,5350,2768,366,1356,0,1046,2582,1820,333,256,127,0,46,0
20160530,,臺中市,33,25,8,185,137,48,114,69,45,22,2,45,27,6,9,3,0,0,2916,1707,504,901,26,276,1209,730,178,233,68,0,0,0
20160530,,臺南市,29,23,6,136,78,58,73,48,27,20,1,25,12,7,3,3,0,0,2275,1617,363,906,6,342,658,348,160,79,71,0,0,0
20160530,,高雄市,35,25,10,155,110,45,93,64,36,28,0,29,4,9,10,3,3,0,3014,2295,471,827,1,996,719,117,245,249,59,49,0,0
20160530,,宜蘭縣,10,7,3,72,31,41,31,16,9,7,0,15,6,3,3,3,0,0,772,449,89,340,0,20,323,142,77,47,57,0,0,0
20160530,,桃園市,28,21,7,122,73,49,80,50,32,18,0,30,6,12,9,3,0,0,2991,2230,413,1172,0,645,761,113,345,244,59,0,0,0
20160530,,新竹縣,6,5,1,25,24,1,20,17,12,5,0,3,0,0,0,3,0,0,515,462,145,222,0,95,53,0,0,0,53,0,0,0
20160530,,苗栗縣,9,7,2,42,36,6,26,20,14,6,0,6,0,6,0,0,0,0,908,756,148,385,1,222,152,0,152,0,0,0,0,0
20160530,,彰化縣,16,13,3,85,64,21,55,37,24,13,0,18,12,3,3,0,0,0,1362,881,297,515,0,69,481,315,82,84,0,0,0,0
20160530,,南投縣,10,7,3,49,36,13,33,21,16,5,0,12,6,3,3,0,0,0,758,446,165,136,0,145,312,161,78,73,0,0,0,0
20160530,,雲林縣,9,6,3,57,29,28,34,22,16,6,0,12,6,3,3,0,0,0,891,598,171,215,0,212,293,167,75,51,0,0,0,0
20160530,,嘉義縣,2,2,0,13,13,0,6,6,5,1,0,0,0,0,0,0,0,0,285,285,50,26,0,209,0,0,0,0,0,0,0,0
20160530,,屏東縣,11,9,2,97,39,58,42,27,19,7,1,15,9,3,3,0,0,0,985,613,220,218,7,168,372,249,70,53,0,0,0,0
20160530,,臺東縣,6,5,1,18,15,3,12,9,6,3,0,3,0,3,0,0,0,0,310,249,65,87,0,97,61,0,61,0,0,0,0,0
20160530,,花蓮縣,7,5,2,61,20,41,29,14,9,5,0,15,9,3,3,0,0,0,674,370,98,144,0,128,304,204,57,43,0,0,0,0
20160530,,澎湖縣,2,1,1,18,10,8,11,5,4,1,0,6,0,3,3,0,0,0,102,56,31,22,0,3,46,0,36,10,0,0,0,0
20160530,,基隆市,4,3,1,22,18,4,15,9,6,3,0,6,0,3,3,0,0,0,415,267,67,111,0,89,148,0,69,79,0,0,0,0
20160530,,新竹市,11,8,3,82,30,52,40,19,12,7,0,21,15,3,3,0,0,0,1250,695,129,287,0,279,555,380,94,81,0,0,0,0
20160530,,嘉義市,6,4,2,67,20,47,31,10,6,4,0,21,12,3,3,3,0,0,864,335,81,189,0,65,529,298,86,81,64,0,0,0
20160530,,金門縣,1,1,0,7,7,0,4,4,3,1,0,0,0,0,0,0,0,0,60,60,22,29,0,9,0,0,0,0,0,0,0,0
20160530,,連江縣,1,1,0,1,1,0,1,1,0,1,0,0,0,0,0,0,0,0,13,13,0,13,0,0,0,0,0,0,0,0,0,0
20161020,,新北市,28,19,9,185,156,29,107,75,56,19,0,32,6,12,12,2,0,0,3414,2578,693,407,72,1406,836,173,306,316,40,0,0,1
20161020,,臺北市,53,37,16,318,156,162,164,70,29,41,0,94,65,12,9,6,0,2,5449,2879,357,1418,2,1102,2570,1793,357,260,135,0,25,0
20161020,,桃園市,29,22,7,123,73,50,83,53,34,19,0,30,6,12,9,3,0,0,3472,2668,431,1171,0,1066,804,167,321,225,64,0,0,27
20161020,,臺中市,33,25,8,176,130,46,114,69,45,22,2,45,27,6,9,3,0,0,3154,1873,540,758,33,542,1281,763,219,228,71,0,0,0
20161020,,臺南市,28,23,5,124,74,50,72,48,27,20,1,24,12,6,3,3,0,0,2346,1688,353,743,2,590,658,336,170,84,68,0,0,0
20161020,,高雄市,35,27,8,160,119,41,96,69,36,33,0,27,3,9,9,3,3,0,2991,2313,467,569,0,1277,678,89,258,259,62,10,0,0
20161020,,宜蘭縣,10,7,3,57,29,28,31,16,9,7,0,15,6,3,3,3,0,0,799,463,104,280,0,79,336,139,85,47,65,0,0,0
20161020,,新竹縣,6,5,1,25,24,1,20,17,12,5,0,3,0,0,0,3,0,0,613,566,157,194,0,215,47,0,0,0,47,0,0,0
20161020,,苗栗縣,9,7,2,38,33,5,26,20,14,6,0,6,0,6,0,0,0,0,953,785,142,375,1,267,168,0,168,0,0,0,0,0
20161020,,彰化縣,16,13,3,86,67,19,55,37,24,13,0,18,12,3,3,0,0,0,1547,979,289,479,0,211,568,325,111,120,12,0,0,0
20161020,,南投縣,10,7,3,42,31,11,32,20,15,5,0,12,6,3,3,0,0,0,743,428,156,103,0,169,315,165,69,81,0,0,0,0
20161020,,雲林縣,9,6,3,58,32,26,36,24,18,6,0,12,6,3,3,0,0,0,996,715,180,211,0,324,281,147,84,50,0,0,0,0
20161020,,嘉義縣,2,2,0,13,13,0,7,7,6,1,0,0,0,0,0,0,0,0,326,326,58,21,0,247,0,0,0,0,0,0,0,0
20161020,,屏東縣,11,9,2,94,36,58,42,27,19,7,1,15,9,3,3,0,0,0,1045,653,219,189,5,240,392,259,80,53,0,0,0,0
20161020,,臺東縣,6,5,1,18,15,3,12,9,6,3,0,3,0,3,0,0,0,0,316,256,60,58,0,138,60,0,60,0,0,0,0,0
20161020,,花蓮縣,7,5,2,54,17,37,29,14,9,5,0,15,9,3,3,0,0,0,675,378,105,124,0,149,297,203,53,41,0,0,0,0
20161020,,澎湖縣,2,1,1,16,9,7,11,5,4,1,0,6,0,3,3,0,0,0,120,73,35,17,0,21,47,0,39,8,0,0,0,0
20161020,,基隆市,5,4,1,22,19,3,16,10,6,3,1,6,0,3,3,0,0,0,416,272,69,87,14,102,144,0,65,79,0,0,0,0
20161020,,新竹市,11,8,3,73,28,45,39,19,12,7,0,20,14,3,3,0,0,0,1401,846,130,234,0,482,555,374,92,89,0,0,0,0
20161020,,嘉義市,6,4,2,66,20,46,31,10,6,4,0,21,12,3,3,3,0,0,1018,419,79,136,0,204,599,359,89,82,69,0,0,0
20161020,,金門縣,1,1,0,6,6,0,4,4,3,1,0,0,0,0,0,0,0,0,91,91,35,32,0,24,0,0,0,0,0,0,0,0
20161020,,連江縣,1,1,0,2,2,0,1,1,0,1,0,0,0,0,0,0,0,0,9,9,0,7,0,2,0,0,0,0,0,0,0,0
20170320,,新北市,28,19,9,177,148,29,107,75,56,19,0,32,6,12,12,2,0,0,3383,2546,690,449,87,1320,837,173,306,317,40,0,0,1
20170320,,臺北市,53,37,16,320,154,166,164,70,29,41,0,94,65,12,9,6,0,2,5461,2889,358,1455,4,1072,2572,1791,354,258,132,0,37,0
20170320,,桃園市,29,22,7,127,76,51,83,53,34,19,0,30,6,12,9,3,0,0,3389,2585,431,1403,0,751,804,167,320,224,66,0,0,27
20170320,,臺中市,33,25,8,174,128,46,114,69,45,22,2,45,27,6,9,3,0,0,3066,1807,529,954,36,288,1259,771,191,227,70,0,0,0
20170320,,臺南市,28,23,5,125,75,50,72,48,27,20,1,24,12,6,3,3,0,0,2329,1672,350,943,2,377,657,337,170,84,66,0,0,0
20170320,,高雄市,35,27,8,161,119,42,96,69,36,33,0,27,3,9,9,3,3,0,2948,2273,480,676,0,1117,675,90,257,256,62,10,0,0
20170320,,宜蘭縣,10,7,3,59,31,28,31,16,9,7,0,15,6,3,3,3,0,0,774,437,90,327,0,20,337,140,85,47,65,0,0,0
20170320,,新竹縣,6,5,1,24,23,1,20,17,12,5,0,3,0,0,0,3,0,0,594,547,157,278,0,112,47,0,0,0,47,0,0,0
20170320,,苗栗縣,10,8,2,39,34,5,27,21,14,7,0,6,0,6,0,0,0,0,915,771,141,442,1,187,144,0,144,0,0,0,0,0
20170320,,彰化縣,16,13,3,87,68,19,55,37,24,13,0,18,12,3,3,0,0,0,1521,955,286,605,0,64,566,325,110,119,12,0,0,0
20170320,,南投縣,10,7,3,42,33,9,32,20,15,5,0,12,6,3,3,0,0,0,731,416,151,123,0,142,315,165,69,81,0,0,0,0
20170320,,雲林縣,9,6,3,46,33,13,36,24,18,6,0,12,6,3,3,0,0,0,1025,713,191,275,0,247,312,177,85,50,0,0,0,0
20170320,,嘉義縣,2,2,0,13,13,0,7,7,6,1,0,0,0,0,0,0,0,0,313,313,59,35,0,219,0,0,0,0,0,0,0,0
20170320,,屏東縣,10,8,2,94,38,56,41,26,19,6,1,15,9,3,3,0,0,0,1024,634,209,228,4,193,390,259,78,53,0,0,0,0
20170320,,臺東縣,6,5,1,21,16,5,12,9,6,3,0,3,0,3,0,0,0,0,308,249,59,79,0,111,59,0,59,0,0,0,0,0
20170320,,花蓮縣,7,5,2,57,20,37,29,14,9,5,0,15,9,3,3,0,0,0,642,345,93,132,0,120,297,203,53,41,0,0,0,0
20170320,,澎湖縣,2,1,1,16,9,7,11,5,4,1,0,6,0,3,3,0,0,0,119,72,34,32,0,6,47,0,36,11,0,0,0,0
20170320,,基隆市,5,4,1,24,20,4,16,10,6,3,1,6,0,3,3,0,0,0,422,280,68,119,14,79,142,0,64,78,0,0,0,0
20170320,,新竹市,11,8,3,74,31,43,39,19,12,7,0,20,14,3,3,0,0,0,1343,799,132,320,0,347,544,365,91,88,0,0,0,0
20170320,,嘉義市,6,4,2,66,20,46,31,10,6,4,0,21,12,3,3,3,0,0,1012,417,78,246,0,93,595,357,88,81,69,0,0,0
20170320,,金門縣,1,1,0,6,6,0,4,4,3,1,0,0,0,0,0,0,0,0,84,84,30,43,0,11,0,0,0,0,0,0,0,0
20170320,,連江縣,1,1,0,2,2,0,1,1,0,1,0,0,0,0,0,0,0,0,10,10,0,10,0,0,0,0,0,0,0,0,0,0
20171020,,新北市,29,20,9,208,175,33,112,80,60,20,0,32,6,12,12,2,0,0,3528,2807,757,586,161,1303,721,168,234,277,41,0,0,1
20171020,,臺北市,54,38,16,345,168,177,165,74,32,42,0,91,62,12,9,6,0,2,5365,2969,364,1529,10,1066,2396,1646,352,246,129,0,23,0
20171020,,桃園市,29,22,7,133,83,50,86,56,36,20,0,30,6,12,9,3,0,0,3722,2900,467,1531,0,902,822,157,323,223,69,0,0,50
20171020,,臺中市,34,25,9,189,134,55,114,68,44,22,2,46,27,7,9,3,0,0,2935,1747,512,892,29,314,1188,726,187,206,69,0,0,0
20171020,,臺南市,28,23,5,128,78,50,72,48,27,20,1,24,12,6,3,3,0,0,2219,1588,344,826,1,417,631,331,153,87,60,0,0,0
20171020,,高雄市,35,27,8,163,124,39,102,75,37,38,0,27,3,9,9,3,3,0,3014,2366,490,685,0,1191,648,89,228,253,69,9,0,0
20171020,,宜蘭縣,10,7,3,58,33,25,32,16,9,7,0,16,7,3,3,3,0,0,782,464,106,315,0,43,318,142,75,35,66,0,0,0
20171020,,新竹縣,8,7,1,27,26,1,22,19,12,7,0,3,0,0,0,3,0,0,602,564,159,306,0,99,38,0,0,0,38,0,0,0
20171020,,苗栗縣,11,9,2,40,35,5,29,23,15,8,0,6,0,6,0,0,0,0,812,718,145,417,0,156,94,0,94,0,0,0,0,0
20171020,,彰化縣,17,14,3,88,67,21,56,38,24,13,1,18,12,3,3,0,0,0,1540,924,285,593,0,46,616,326,141,123,26,0,0,0
20171020,,南投縣,10,7,3,42,33,9,32,20,15,5,0,12,6,3,3,0,0,0,686,467,171,135,0,161,219,110,53,56,0,0,0,0
20171020,,雲林縣,9,6,3,58,45,13,37,25,19,6,0,12,6,3,3,0,0,0,1007,753,202,298,0,253,254,117,86,51,0,0,0,0
20171020,,嘉義縣,2,2,0,11,11,0,7,7,6,1,0,0,0,0,0,0,0,0,342,342,60,41,0,241,0,0,0,0,0,0,0,0
20171020,,屏東縣,10,8,2,81,37,44,41,26,19,6,1,15,9,3,3,0,0,0,967,644,202,234,2,206,323,217,56,50,0,0,0,0
20171020,,臺東縣,6,5,1,19,14,5,12,9,6,3,0,3,0,3,0,0,0,0,304,241,54,80,0,107,63,0,63,0,0,0,0,0
20171020,,花蓮縣,7,5,2,47,20,27,29,14,9,5,0,15,9,3,3,0,0,0,653,372,89,153,0,130,281,195,48,38,0,0,0,0
20171020,,澎湖縣,2,1,1,15,9,6,11,5,4,1,0,6,0,3,3,0,0,0,116,83,30,38,0,15,33,0,25,8,0,0,0,0
20171020,,基隆市,5,4,1,23,19,4,16,10,6,3,1,6,0,3,3,0,0,0,433,308,72,138,6,92,125,0,59,66,0,0,0,0
20171020,,新竹市,11,8,3,71,29,42,38,19,12,7,0,19,13,3,3,0,0,0,1255,801,133,277,1,390,454,273,93,88,0,0,0,0
20171020,,嘉義市,8,6,2,66,20,46,33,12,6,6,0,21,12,3,3,3,0,0,902,426,77,317,0,32,476,238,90,80,68,0,0,0
20171020,,金門縣,1,1,0,6,6,0,4,4,3,1,0,0,0,0,0,0,0,0,84,84,29,44,0,11,0,0,0,0,0,0,0,0
20171020,,連江縣,1,1,0,2,2,0,1,1,0,1,0,0,0,0,0,0,0,0,12,12,0,12,0,0,0,0,0,0,0,0,0,0
20180320,,新北市,29,20,9,208,175,33,112,80,60,20,0,32,6,12,12,2,0,0,3481,2763,751,607,176,1229,718,168,223,285,41,0,0,1
20180320,,臺北市,54,38,16,345,168,177,165,74,32,42,0,91,62,12,9,6,0,2,5374,2939,362,1520,10,1047,2435,1677,351,248,129,0,30,0
20180320,,桃園市,29,22,7,133,83,50,86,56,36,20,0,30,6,12,9,3,0,0,3558,2763,463,1498,0,802,795,159,295,222,70,0,0,49
20180320,,臺中市,34,25,9,189,134,55,114,68,44,22,2,46,27,7,9,3,0,0,2932,1707,505,872,30,300,1225,764,189,203,69,0,0,0
20180320,,臺南市,28,23,5,128,78,50,72,48,27,20,1,24,12,6,3,3,0,0,2195,1566,344,839,1,382,629,334,149,86,60,0,0,0
20180320,,高雄市,35,27,8,163,124,39,102,75,37,38,0,27,3,9,9,3,3,0,3016,2349,494,666,0,1189,667,89,248,252,69,9,0,0
20180320,,宜蘭縣,10,7,3,58,33,25,32,16,9,7,0,16,7,3,3,3,0,0,764,416,89,305,0,22,348,170,75,39,64,0,0,0
20180320,,新竹縣,8,7,1,27,26,1,22,19,12,7,0,3,0,0,0,3,0,0,585,548,155,294,0,99,37,0,0,0,37,0,0,0
20180320,,苗栗縣,11,9,2,40,35,5,29,23,15,8,0,6,0,6,0,0,0,0,848,711,141,413,0,157,137,0,137,0,0,0,0,0
20180320,,彰化縣,17,14,3,88,67,21,56,38,24,13,1,18,12,3,3,0,0,0,1542,923,284,570,2,67,619,326,140,127,26,0,0,0
20180320,,南投縣,10,7,3,42,33,9,32,20,15,5,0,12,6,3,3,0,0,0,727,454,170,125,0,159,273,157,51,65,0,0,0,0
20180320,,雲林縣,9,6,3,58,45,13,37,25,19,6,0,12,6,3,3,0,0,0,1040,729,220,268,0,241,311,175,86,50,0,0,0,0
20180320,,嘉義縣,2,2,0,11,11,0,7,7,6,1,0,0,0,0,0,0,0,0,321,321,60,36,1,224,0,0,0,0,0,0,0,0
20180320,,屏東縣,10,8,2,81,37,44,41,26,19,6,1,15,9,3,3,0,0,0,1014,631,198,218,5,210,383,247,86,50,0,0,0,0
20180320,,臺東縣,6,5,1,19,14,5,12,9,6,3,0,3,0,3,0,0,0,0,298,237,56,79,0,102,61,0,61,0,0,0,0,0
20180320,,花蓮縣,7,5,2,47,20,27,29,14,9,5,0,15,9,3,3,0,0,0,649,367,82,170,0,115,282,195,49,38,0,0,0,0
20180320,,澎湖縣,2,1,1,15,9,6,11,5,4,1,0,6,0,3,3,0,0,0,126,81,31,35,0,15,45,0,35,10,0,0,0,0
20180320,,基隆市,5,4,1,23,19,4,16,10,6,3,1,6,0,3,3,0,0,0,432,309,67,135,5,102,123,0,55,68,0,0,0,0
20180320,,新竹市,11,8,3,71,29,42,38,19,12,7,0,19,13,3,3,0,0,0,1322,778,134,280,0,364,544,362,93,89,0,0,0,0
20180320,,嘉義市,8,6,2,66,20,46,33,12,6,6,0,21,12,3,3,3,0,0,1016,420,77,306,0,37,596,357,91,80,68,0,0,0
20180320,,金門縣,0,0,0,6,6,0,4,4,3,1,0,0,0,0,0,0,0,0,81,81,28,46,0,7,0,0,0,0,0,0,0,0
20180320,,連江縣,0,0,0,2,2,0,1,1,0,1,0,0,0,0,0,0,0,0,12,12,0,12,0,0,0,0,0,0,0,0,0,0
20180528,,新北市,29,20,9,209,176,33,112,80,60,20,0,32,6,12,12,2,0,0,3453,2733,747,602,250,1134,720,168,222,288,41,0,0,1
20180528,,臺北市,54,38,16,344,168,176,165,74,32,42,0,91,62,12,9,6,0,2,5388,2941,363,1512,9,1057,2447,1675,351,248,129,0,44,0
20180528,,桃園市,29,22,7,141,91,50,86,56,36,20,0,30,6,12,9,3,0,0,3549,2756,463,1497,2,794,793,158,295,221,70,0,0,49
20180528,,臺中市,27,18,9,152,114,38,106,60,44,14,2,46,27,7,9,3,0,0,2925,1700,507,558,29,606,1225,763,189,204,69,0,0,0
20180528,,臺南市,28,23,5,136,73,63,72,48,27,20,1,24,12,6,3,3,0,0,2193,1565,344,847,1,373,628,333,149,86,60,0,0,0
20180528,,高雄市,35,27,8,164,126,38,102,75,37,38,0,27,3,9,9,3,3,0,3006,2339,492,666,30,1151,667,89,248,252,69,9,0,0
20180528,,宜蘭縣,10,7,3,58,33,25,32,16,9,7,0,16,7,3,3,3,0,0,764,416,88,308,0,20,348,170,75,39,64,0,0,0
20180528,,新竹縣,8,7,1,25,24,1,22,19,12,7,0,3,0,0,0,3,0,0,583,546,153,291,0,102,37,0,0,0,37,0,0,0
20180528,,苗栗縣,11,9,2,40,35,5,29,23,15,8,0,6,0,6,0,0,0,0,847,709,140,412,0,157,138,0,138,0,0,0,0,0
20180528,,彰化縣,17,14,3,89,65,24,56,38,24,13,1,18,12,3,3,0,0,0,1515,896,287,557,1,51,619,326,140,127,26,0,0,0
20180528,,南投縣,10,7,3,42,33,9,32,20,15,5,0,12,6,3,3,0,0,0,726,454,165,126,0,163,272,157,51,64,0,0,0,0
20180528,,雲林縣,9,6,3,65,45,20,37,25,19,6,0,12,6,3,3,0,0,0,1035,724,219,267,0,238,311,175,86,50,0,0,0,0
20180528,,嘉義縣,2,2,0,11,11,0,7,7,6,1,0,0,0,0,0,0,0,0,315,315,59,36,1,219,0,0,0,0,0,0,0,0
20180528,,屏東縣,10,8,2,85,40,45,41,26,19,6,1,15,9,3,3,0,0,0,1012,629,200,224,5,200,383,247,86,50,0,0,0,0
20180528,,臺東縣,6,5,1,21,16,5,12,9,6,3,0,3,0,3,0,0,0,0,295,234,55,78,0,101,61,0,61,0,0,0,0,0
20180528,,花蓮縣,7,5,2,62,19,43,29,14,9,5,0,15,9,3,3,0,0,0,642,360,82,170,0,108,282,195,49,38,0,0,0,0
20180528,,澎湖縣,2,1,1,15,9,6,11,5,4,1,0,6,0,3,3,0,0,0,126,81,31,35,0,15,45,0,35,10,0,0,0,0
20180528,,基隆市,5,4,1,23,19,4,16,10,6,3,1,6,0,3,3,0,0,0,431,307,67,135,5,100,124,0,55,69,0,0,0,0
20180528,,新竹市,11,8,3,71,28,43,38,19,12,7,0,19,13,3,3,0,0,0,1319,775,134,282,0,359,544,362,93,89,0,0,0,0
20180528,,嘉義市,8,6,2,70,22,48,33,12,6,6,0,21,12,3,3,3,0,0,1013,417,77,304,0,36,596,357,91,80,68,0,0,0
20180528,,金門縣,0,0,0,7,7,0,4,4,3,1,0,0,0,0,0,0,0,0,80,80,28,45,0,7,0,0,0,0,0,0,0,0
20180528,,連江縣,0,0,0,2,2,0,1,1,0,1,0,0,0,0,0,0,0,0,12,12,0,12,0,0,0,0,0,0,0,0,0,0
20181020,,新北市,32,23,9,206,174,32,117,84,60,24,0,33,6,12,12,3,0,0,3429,2826,740,511,173,1402,603,143,174,239,45,0,0,2
20181020,,臺北市,54,38,16,360,173,187,164,76,33,43,0,88,59,12,9,6,0,2,5216,2947,329,1545,6,1067,2269,1556,319,249,125,0,20,0
20181020,,桃園市,31,24,7,143,95,48,88,58,36,22,0,30,6,12,9,3,0,0,3684,2871,435,1361,3,1072,813,176,312,208,67,0,0,50
20181020,,臺中市,27,18,9,174,111,63,105,58,42,14,2,47,27,8,9,3,0,0,2692,1605,499,561,48,497,1087,659,169,195,64,0,0,0
20181020,,臺南市,28,23,5,134,71,63,72,48,27,20,1,24,12,6,3,3,0,0,2178,1552,324,833,5,390,626,339,142,86,59,0,0,0
20181020,,高雄市,37,28,9,158,122,36,108,80,36,44,0,28,3,9,10,3,3,0,2979,2324,483,668,29,1144,655,89,228,261,68,9,0,0
20181020,,宜蘭縣,10,7,3,57,32,25,31,15,8,7,0,16,7,3,3,3,0,0,721,385,89,285,0,11,336,169,76,37,54,0,0,0
20181020,,新竹縣,7,6,1,27,26,1,21,18,12,6,0,3,0,0,0,3,0,0,618,598,153,286,0,159,20,0,0,0,20,0,0,0
20181020,,苗栗縣,11,9,2,38,33,5,27,21,13,8,0,6,0,6,0,0,0,0,775,654,130,393,0,131,121,0,121,0,0,0,0,0
20181020,,彰化縣,17,14,3,90,66,24,56,38,24,13,1,18,12,3,3,0,0,0,1518,929,282,583,4,60,589,320,137,106,26,0,0,0
20181020,,南投縣,10,7,3,42,33,9,32,20,15,5,0,12,6,3,3,0,0,0,722,480,163,137,0,180,242,155,40,45,2,0,0,0
20181020,,雲林縣,9,6,3,67,44,23,37,25,19,6,0,12,6,3,3,0,0,0,1119,810,216,347,0,247,309,177,85,47,0,0,0,0
20181020,,嘉義縣,3,3,0,12,12,0,7,7,5,2,0,0,0,0,0,0,0,0,322,322,55,70,1,196,0,0,0,0,0,0,0,0
20181020,,屏東縣,10,8,2,79,36,43,39,24,17,6,1,15,9,3,3,0,0,0,1051,679,193,257,10,219,372,232,88,52,0,0,0,0
20181020,,臺東縣,6,5,1,19,16,3,13,10,6,4,0,3,0,3,0,0,0,0,330,265,60,149,0,56,65,0,65,0,0,0,0,0
20181020,,花蓮縣,7,5,2,64,18,46,29,14,9,5,0,15,9,3,3,0,0,0,697,410,75,211,0,124,287,206,43,38,0,0,0,0
20181020,,澎湖縣,2,1,1,14,8,6,12,5,4,1,0,7,0,3,3,1,0,0,147,101,33,46,0,22,46,0,36,5,5,0,0,0
20181020,,基隆市,5,4,1,22,18,4,16,10,6,3,1,6,0,3,3,0,0,0,406,319,73,160,7,79,87,0,37,50,0,0,0,0
20181020,,新竹市,11,8,3,64,27,37,37,19,12,7,0,18,12,3,3,0,0,0,1241,786,137,302,0,347,455,276,89,90,0,0,0,0
20181020,,嘉義市,8,6,2,64,23,41,33,12,6,6,0,21,12,3,3,3,0,0,1046,450,75,331,0,44,596,359,89,83,65,0,0,0
20181020,,金門縣,0,0,0,8,8,0,4,4,3,1,0,0,0,0,0,0,0,0,90,90,29,56,0,5,0,0,0,0,0,0,0,0
20181020,,連江縣,0,0,0,1,1,0,1,1,0,1,0,0,0,0,0,0,0,0,12,12,0,12,0,0,0,0,0,0,0,0,0,0
20190320,,新北市,33,24,9,211,179,32,117,84,60,24,0,33,6,12,12,3,0,0,3449,2792,732,656,102,1302,657,144,205,260,46,0,0,2
20190320,,臺北市,54,38,16,353,170,183,164,76,33,43,0,88,59,12,9,6,0,2,5262,2910,325,1539,5,1041,2352,1549,354,247,124,0,78,0
20190320,,桃園市,31,24,7,146,98,48,88,58,36,22,0,30,6,12,9,3,0,0,3592,2778,425,1321,1,1031,814,175,316,207,67,0,0,49
20190320,,臺中市,27,18,9,172,109,63,105,58,42,14,2,47,27,8,9,3,0,0,2516,1310,498,542,46,224,1206,750,198,194,64,0,0,0
20190320,,臺南市,28,23,5,143,80,63,72,48,27,20,1,24,12,6,3,3,0,0,2174,1547,332,834,1,380,627,340,143,85,59,0,0,0
20190320,,高雄市,37,28,9,162,122,40,108,80,36,44,0,28,3,9,10,3,3,0,2951,2304,491,631,0,1182,647,84,228,259,67,9,0,0
20190320,,宜蘭縣,10,7,3,56,33,23,31,15,8,7,0,16,7,3,3,3,0,0,745,384,88,286,0,10,361,195,76,36,54,0,0,0
20190320,,新竹縣,7,6,1,28,27,1,21,18,12,6,0,3,0,0,0,3,0,0,624,587,149,325,0,113,37,0,0,0,37,0,0,0
20190320,,苗栗縣,11,9,2,39,34,5,27,21,13,8,0,6,0,6,0,0,0,0,774,648,133,395,0,120,126,0,126,0,0,0,0,0
20190320,,彰化縣,17,14,3,89,65,24,56,38,24,13,1,18,12,3,3,0,0,0,1590,968,278,574,21,95,622,321,137,138,26,0,0,0
20190320,,南投縣,10,7,3,43,33,10,32,20,15,5,0,12,6,3,3,0,0,0,695,455,164,128,0,163,240,154,41,45,0,0,0,0
20190320,,雲林縣,9,6,3,68,45,23,37,25,19,6,0,12,6,3,3,0,0,0,1095,789,210,336,0,243,306,173,85,48,0,0,0,0
20190320,,嘉義縣,3,3,0,12,12,0,7,7,5,2,0,0,0,0,0,0,0,0,330,330,62,68,1,199,0,0,0,0,0,0,0,0
20190320,,屏東縣,10,8,2,83,40,43,39,24,17,6,1,15,9,3,3,0,0,0,1050,667,191,250,12,214,383,232,97,52,2,0,0,0
20190320,,臺東縣,6,5,1,19,16,3,13,10,6,4,0,3,0,3,0,0,0,0,335,270,61,146,0,63,65,0,65,0,0,0,0,0
20190320,,花蓮縣,7,5,2,63,18,45,29,14,9,5,0,15,9,3,3,0,0,0,709,422,75,210,0,137,287,205,44,38,0,0,0,0
20190320,,澎湖縣,2,1,1,17,10,7,12,5,4,1,0,7,0,3,3,1,0,0,145,100,33,44,0,23,45,0,35,5,5,0,0,0
20190320,,基隆市,5,4,1,24,20,4,16,10,6,3,1,6,0,3,3,0,0,0,412,324,78,156,8,82,88,0,37,51,0,0,0,0
20190320,,新竹市,11,8,3,69,31,38,37,19,12,7,0,18,12,3,3,0,0,0,1278,747,129,292,0,326,531,351,89,91,0,0,0,0
20190320,,嘉義市,8,6,2,64,23,41,33,12,6,6,0,21,12,3,3,3,0,0,1036,444,74,335,0,35,592,357,89,81,65,0,0,0
20190320,,金門縣,0,0,0,8,8,0,4,4,3,1,0,0,0,0,0,0,0,0,87,87,27,55,0,5,0,0,0,0,0,0,0,0
20190320,,連江縣,0,0,0,1,1,0,1,1,0,1,0,0,0,0,0,0,0,0,12,12,0,12,0,0,0,0,0,0,0,0,0,0
20190528,,新北市,33,24,9,230,180,50,117,84,60,24,0,33,6,12,12,3,0,0,3438,2782,728,753,146,1155,656,144,205,259,46,0,0,2
20190528,,臺北市,54,38,16,335,152,183,164,76,33,43,0,88,59,12,9,6,0,2,5208,2879,325,1531,5,1018,2329,1529,354,246,123,0,77,0
20190528,,桃園市,31,24,7,146,98,48,88,58,36,22,0,30,6,12,9,3,0,0,3582,2766,426,1317,1,1022,816,175,316,209,67,0,0,49
20190528,,臺中市,27,18,9,185,111,74,105,58,42,14,2,47,27,8,9,3,0,0,2512,1306,495,539,44,228,1206,750,198,194,64,0,0,0
20190528,,臺南市,28,23,5,143,80,63,72,48,27,20,1,24,12,6,3,3,0,0,2160,1536,332,824,1,379,624,334,143,88,59,0,0,0
20190528,,高雄市,37,28,9,160,120,40,108,80,36,44,0,28,3,9,10,3,3,0,2938,2289,488,631,0,1170,649,85,228,260,67,9,0,0
20190528,,宜蘭縣,10,7,3,56,33,23,31,15,8,7,0,16,7,3,3,3,0,0,739,377,85,282,0,10,362,195,76,37,54,0,0,0
20190528,,新竹縣,7,6,1,28,27,1,21,18,12,6,0,3,0,0,0,3,0,0,601,567,147,323,0,97,34,0,0,0,34,0,0,0
20190528,,苗栗縣,11,9,2,39,34,5,27,21,13,8,0,6,0,6,0,0,0,0,772,646,132,395,0,119,126,0,126,0,0,0,0,0
20190528,,彰化縣,17,14,3,89,65,24,56,38,24,13,1,18,12,3,3,0,0,0,1606,984,279,569,21,115,622,321,137,138,26,0,0,0
20190528,,南投縣,10,7,3,43,33,10,32,20,15,5,0,12,6,3,3,0,0,0,687,447,164,126,0,157,240,154,41,45,0,0,0,0
20190528,,雲林縣,9,6,3,67,44,23,37,25,19,6,0,12,6,3,3,0,0,0,1093,786,210,336,0,240,307,174,85,48,0,0,0,0
20190528,,嘉義縣,3,3,0,12,12,0,7,7,5,2,0,0,0,0,0,0,0,0,326,326,62,70,1,193,0,0,0,0,0,0,0,0
20190528,,屏東縣,10,8,2,83,40,43,39,24,17,6,1,15,9,3,3,0,0,0,1039,659,189,248,11,211,380,232,94,52,2,0,0,0
20190528,,臺東縣,6,5,1,19,16,3,13,10,6,4,0,3,0,3,0,0,0,0,334,268,61,145,0,62,66,0,66,0,0,0,0,0
20190528,,花蓮縣,7,5,2,63,18,45,29,14,9,5,0,15,9,3,3,0,0,0,710,423,76,208,0,139,287,205,44,38,0,0,0,0
20190528,,澎湖縣,2,1,1,17,10,7,12,5,4,1,0,7,0,3,3,1,0,0,145,100,33,44,0,23,45,0,35,5,5,0,0,0
20190528,,基隆市,5,4,1,24,20,4,16,10,6,3,1,6,0,3,3,0,0,0,406,316,75,152,8,81,90,0,37,52,0,0,0,1
20190528,,新竹市,11,8,3,69,31,38,37,19,12,7,0,18,12,3,3,0,0,0,1286,756,129,294,0,333,530,350,89,91,0,0,0,0
20190528,,嘉義市,8,6,2,64,23,41,33,12,6,6,0,21,12,3,3,3,0,0,1037,445,74,337,0,34,592,357,89,81,65,0,0,0
20190528,,金門縣,1,1,0,8,8,0,4,4,3,1,0,0,0,0,0,0,0,0,86,86,27,54,0,5,0,0,0,0,0,0,0,0
20190528,,連江縣,1,1,0,1,1,0,1,1,0,1,0,0,0,0,0,0,0,0,12,12,0,12,0,0,0,0,0,0,0,0,0,0
